,id,release_date,movie,production_budget,domestic_gross,worldwide_gross,total_profit,was_it_profitable_domestically
0,1,2009-12-18,avatar,425000000,760507625,2776345279,2351345279,True
1,2,2011-05-20,pirates of the caribbean: on stranger tides,410600000,241063875,1045663875,635063875,False
2,3,2019-06-07,dark phoenix,350000000,42762350,149762350,-200237650,False
3,4,2015-05-01,avengers: age of ultron,330600000,459005868,1403013963,1072413963,True
4,5,2017-12-15,star wars ep. viii: the last jedi,317000000,620181382,1316721747,999721747,True
5,6,2015-12-18,star wars ep. vii: the force awakens,306000000,936662225,2053311220,1747311220,True
6,7,2018-04-27,avengers: infinity war,300000000,678815482,2048134200,1748134200,True
7,8,2007-05-24,pirates of the caribbean: at worldâs end,300000000,309420425,963420425,663420425,True
8,9,2017-11-17,justice league,300000000,229024295,655945209,355945209,False
9,10,2015-11-06,spectre,300000000,200074175,879620923,579620923,False
10,11,2012-07-20,the dark knight rises,275000000,448139099,1084439099,809439099,True
11,12,2018-05-25,solo: a star wars story,275000000,213767512,393151347,118151347,False
12,13,2013-07-02,the lone ranger,275000000,89302115,260002115,-14997885,False
13,14,2012-03-09,john carter,275000000,73058679,282778100,7778100,False
14,15,2010-11-24,tangled,260000000,200821936,586477240,326477240,False
15,16,2007-05-04,spider-man 3,258000000,336530303,894860230,636860230,True
16,17,2016-05-06,captain america: civil war,250000000,408084349,1140069413,890069413,True
17,18,2016-03-25,batman v superman: dawn of justice,250000000,330360194,867500281,617500281,True
18,19,2012-12-14,the hobbit: an unexpected journey,250000000,303003568,1017003568,767003568,True
19,20,2009-07-15,harry potter and the half-blood prince,250000000,302089278,935213767,685213767,True
20,21,2013-12-13,the hobbit: the desolation of smaug,250000000,258366855,960366855,710366855,True
21,22,2014-12-17,the hobbit: the battle of the five armies,250000000,255119788,945577621,695577621,True
22,23,2017-04-14,the fate of the furious,250000000,225764765,1234846267,984846267,False
23,24,2006-06-28,superman returns,232000000,200120000,374085065,142085065,False
24,25,2017-05-26,pirates of the caribbean: dead men tell no tales,230000000,172558876,788241137,558241137,False
25,26,2008-11-14,quantum of solace,230000000,169368427,591692078,361692078,False
26,27,2012-05-04,the avengers,225000000,623279547,1517935897,1292935897,True
27,28,2006-07-07,pirates of the caribbean: dead manâs chest,225000000,423315812,1066215812,841215812,True
28,29,2013-06-14,man of steel,225000000,291045518,667999518,442999518,True
29,30,2008-05-16,the chronicles of narnia: prince caspian,225000000,141621490,417341288,192341288,False
30,31,2012-07-03,the amazing spider-man,220000000,262030663,757890267,537890267,True
31,32,2012-05-18,battleship,220000000,65233400,313477717,93477717,False
32,33,2017-06-21,transformers: the last knight,217000000,130168683,602893340,385893340,False
33,34,2015-06-12,jurassic world,215000000,652270625,1648854864,1433854864,True
34,35,2012-05-25,men in black 3,215000000,179020854,654213485,439213485,False
35,36,2009-06-24,transformers: revenge of the fallen,210000000,402111870,836519699,626519699,True
36,37,2014-06-27,transformers: age of extinction,210000000,245439076,1104039076,894039076,True
37,38,2006-05-26,x-men: the last stand,210000000,234362462,459260946,249260946,True
38,39,2010-05-14,robin hood,210000000,105487148,322459006,112459006,False
39,40,2005-12-14,king kong,207000000,218080025,550517357,343517357,True
40,41,2007-12-07,the golden compass,205000000,70107728,367262558,162262558,False
41,42,2018-02-16,black panther,200000000,700059566,1348258224,1148258224,True
42,43,1997-12-19,titanic,200000000,659363944,2208208395,2008208395,True
43,44,2018-06-15,incredibles 2,200000000,608581744,1242520711,1042520711,True
44,45,2016-12-16,rogue one: a star wars story,200000000,532177324,1049102856,849102856,True
45,46,2016-06-17,finding dory,200000000,486295561,1021215193,821215193,True
46,47,2010-06-18,toy story 3,200000000,415004880,1068879522,868879522,True
47,48,2013-05-03,iron man 3,200000000,408992272,1215392272,1015392272,True
48,49,2017-05-05,guardians of the galaxy vol 2,200000000,389813101,862316233,662316233,True
49,50,2004-06-30,spider-man 2,200000000,373524485,795110670,595110670,True
50,51,2010-03-05,alice in wonderland,200000000,334191110,1025491110,825491110,True
51,52,2012-11-08,skyfall,200000000,304360277,1110526981,910526981,True
52,53,2013-06-21,monsters university,200000000,268488329,743588329,543588329,True
53,54,2013-03-08,oz the great and powerful,200000000,234770996,490359051,290359051,True
54,55,2014-05-23,x-men: days of future past,200000000,233921534,747862775,547862775,True
55,56,2014-05-02,the amazing spider-man 2,200000000,202853933,708996336,508996336,True
56,57,2011-06-24,cars 2,200000000,191450875,560155383,360155383,False
57,58,2010-12-17,tron: legacy,200000000,172062763,400062763,200062763,False
58,59,2009-11-13,2012,200000000,166112167,757677748,557677748,False
59,60,2018-11-16,fantastic beasts: the crimes of grindelwald,200000000,159555901,652220086,452220086,False
60,61,2009-05-21,terminator salvation,200000000,125322469,365491792,165491792,False
61,62,2011-06-17,green lantern,200000000,116601172,219535492,19535492,False
62,63,2010-05-28,prince of persia: sands of time,200000000,90759676,336359676,136359676,False
63,64,2011-06-29,transformers: dark of the moon,195000000,352390543,1123790543,928790543,True
64,65,2017-06-09,the mummy,195000000,80101125,409953905,214953905,False
65,66,2013-03-01,jack the giant slayer,195000000,65187603,197687603,2687603,False
66,67,2015-04-03,furious 7,190000000,353007020,1518722794,1328722794,True
67,68,2013-05-16,star trek into darkness,190000000,228778661,467381584,277381584,True
68,69,2013-06-21,world war z,190000000,202359711,531514650,341514650,True
69,70,2013-05-10,the great gatsby,190000000,144840419,351040419,161040419,False
70,71,2009-11-06,disneyâs a christmas carol,190000000,137855863,315709697,125709697,False
71,72,2013-07-12,pacific rim,190000000,101802906,411002906,221002906,False
72,73,2015-11-25,the good dinosaur,187500000,123087120,333771037,146271037,False
73,74,2008-05-02,iron man,186000000,318604126,585171547,399171547,True
74,75,2008-07-18,the dark knight,185000000,533720947,1001996207,816996207,True
75,76,2008-05-22,indiana jones and the kingdom of the crystal skull,185000000,317101119,786635413,601635413,True
76,77,2012-06-22,brave,185000000,237282182,554606532,369606532,True
77,78,2017-03-10,kong: skull island,185000000,168052812,561072059,376072059,False
78,79,2016-07-22,star trek beyond,185000000,158848340,335802233,150802233,False
79,80,2017-10-06,blade runner 2049,185000000,92054159,259357408,74357408,False
80,81,2019-05-24,aladdin,182000000,246734314,619234314,437234314,True
81,82,2017-11-03,thor: ragnarok,180000000,315058289,846980024,666980024,True
82,83,2005-12-09,"the chronicles of narnia: the lion, the witch and the wardrobe",180000000,291710957,720539572,540539572,True
83,84,2014-05-30,maleficent,180000000,241407328,758536735,578536735,True
84,85,2016-11-18,fantastic beasts and where to find them,180000000,234037575,802402853,622402853,True
85,86,2008-06-27,wall-e,180000000,223808164,532508025,352508025,True
86,87,2007-08-10,rush hour 3,180000000,140125968,256585882,76585882,False
87,88,2016-07-01,the legend of tarzan,180000000,126643061,348902025,168902025,False
88,89,2011-11-23,hugo,180000000,73864507,180047784,47784,False
89,90,2017-07-21,valerian and the city of a thousand planets,180000000,40479370,215098356,35098356,False
90,91,2015-02-06,jupiter ascending,179000000,47482519,181982519,2982519,False
91,92,2018-07-27,mission: impossibleâfallout,178000000,220159104,787456552,609456552,True
92,93,2016-05-27,x-men: apocalypse,178000000,155442489,542537546,364537546,False
93,94,2018-08-10,the meg,178000000,145443742,529530715,351530715,False
94,95,2014-06-06,edge of tomorrow,178000000,100206256,370541256,192541256,False
95,96,2019-03-08,captain marvel,175000000,426525952,1123061550,948061550,True
96,97,2016-04-15,the jungle book,175000000,364001123,962854547,787854547,True
97,98,2015-06-19,inside out,175000000,356461711,854235992,679235992,True
98,99,2017-07-07,spider-man: homecoming,175000000,334201140,880166350,705166350,True
99,100,2016-08-05,suicide squad,175000000,325100054,746059887,571059887,True
100,1,2009-05-29,up,175000000,293004164,731463377,556463377,True
101,2,2017-11-22,coco,175000000,209726015,798008101,623008101,True
102,3,2018-11-21,ralph breaks the internet,175000000,201091711,524283695,349283695,True
103,4,2009-03-27,monsters vs. aliens,175000000,198351526,381687380,206687380,True
104,5,2017-06-16,cars 3,175000000,152901115,383541369,208541369,False
105,6,2009-08-07,g.i. joe: the rise of cobra,175000000,150201498,302469017,127469017,False
106,7,1999-06-30,wild wild west,175000000,113805681,221229335,46229335,False
107,8,2008-08-01,the mummy: tomb of the dragon emperor,175000000,102491776,405760225,230760225,False
108,9,2007-06-22,evan almighty,175000000,100289690,174131329,-868671,False
109,10,1995-07-28,waterworld,175000000,88246220,264246220,89246220,False
110,11,2017-05-12,king arthur: legend of the sword,175000000,39175066,139630336,-35369664,False
111,12,2013-12-25,47 ronin,175000000,38362475,151716815,-23283185,False
112,13,2018-06-22,jurassic world: fallen kingdom,170000000,417719760,1305772799,1135772799,True
113,14,2014-08-01,guardians of the galaxy,170000000,333172112,770867516,600867516,True
114,15,2010-05-07,iron man 2,170000000,312433331,621156389,451156389,True
115,16,2014-04-04,captain america: the winter soldier,170000000,259746958,714401889,544401889,True
116,17,2014-07-11,dawn of the planet of the apes,170000000,208545589,710644566,540644566,True
117,18,2004-11-10,the polar express,170000000,187224605,311365187,141365187,True
118,19,2012-06-01,snow white and the huntsman,170000000,155136755,401021746,231021746,False
119,20,2003-07-01,terminator 3: rise of the machines,170000000,150358296,433058296,263058296,False
120,21,2004-05-07,van helsing,170000000,120150546,300150546,130150546,False
121,22,2019-03-29,dumbo,170000000,113883318,345004422,175004422,False
122,23,2015-05-22,tomorrowland,170000000,93436322,206627518,36627518,False
123,24,2019-02-14,alita: battle angel,170000000,85710210,402976036,232976036,False
124,25,2019-05-31,godzilla: king of the monsters,170000000,85576941,299276941,129276941,False
125,26,2016-05-27,alice through the looking glass,170000000,77042381,276928112,106928112,False
126,27,2010-05-21,shrek forever after,165000000,238736787,756244673,591244673,True
127,28,2016-11-04,doctor strange,165000000,232641920,676404566,511404566,True
128,29,2014-11-07,big hero 6,165000000,222527828,652127828,487127828,True
129,30,2010-03-26,how to train your dragon,165000000,217581232,494870992,329870992,True
130,31,2012-11-02,wreck-it ralph,165000000,189412677,496511521,331511521,True
131,32,2014-11-05,interstellar,165000000,188017894,666379375,501379375,True
132,33,2016-06-24,independence day: resurgence,165000000,103144286,384169424,219169424,False
133,34,2011-07-29,cowboys and aliens,163000000,100368560,176038324,13038324,False
134,35,2017-03-17,beauty and the beast,160000000,504014165,1259199706,1099199706,True
135,36,2018-12-21,aquaman,160000000,335061807,1146894640,986894640,True
136,37,2007-05-17,shrek the third,160000000,322719944,807330936,647330936,True
137,38,2010-07-16,inception,160000000,292576195,835524642,675524642,True
138,39,2015-11-20,the hunger games: mockingjay - part 2,160000000,281723902,648986787,488986787,True
139,40,2013-05-24,fast and furious 6,160000000,238679850,789300444,629300444,True
140,41,2014-05-16,godzilla,160000000,200676069,529076069,369076069,True
141,42,2011-06-03,x-men: first class,160000000,146408305,355408305,195408305,False
142,43,2008-12-25,the curious case of benjamin button,160000000,127509326,329631958,169631958,False
143,44,2010-07-14,the sorcerer's apprentice,160000000,63150991,217986320,57986320,False
144,45,2006-05-12,poseidon,160000000,60674817,181674817,21674817,False
145,46,2016-06-10,warcraft,160000000,47225655,425522281,265522281,False
146,47,2016-09-30,deepwater horizon,156000000,61433527,122603824,-33396176,False
147,48,2010-12-10,the chronicles of narnia: the voyage of the dawn treader,155000000,104386950,418186950,263186950,False
148,49,2015-07-01,terminator: genisys,155000000,89760956,432150894,277150894,False
149,50,2018-03-23,pacific rim: uprising,155000000,59874525,290930148,135930148,False
150,51,2004-11-24,alexander,155000000,34297191,167297191,12297191,False
151,52,2017-07-14,war for the planet of the apes,152000000,146880162,489592267,337592267,False
152,53,2001-05-25,pearl harbor,151500000,198539855,449239855,297739855,True
153,54,2007-07-02,transformers,151000000,319246193,708272592,557272592,True
154,55,2017-06-02,wonder woman,150000000,412563408,821133378,671133378,True
155,56,2013-11-22,frozen,150000000,400738009,1272469910,1122469910,True
156,57,2016-03-04,zootopia,150000000,341268248,1019429616,869429616,True
157,58,2007-07-11,harry potter and the order of the phoenix,150000000,292137260,943076457,793076457,True
158,59,2005-11-18,harry potter and the goblet of fire,150000000,290201752,897099794,747099794,True
159,60,2003-05-15,the matrix reloaded,150000000,281553689,738576929,588576929,True
160,61,2007-12-14,i am legend,150000000,256393010,585532684,435532684,True
161,62,2016-11-23,moana,150000000,248757044,637517365,487517365,True
162,63,2008-07-01,hancock,150000000,227946274,624234272,474234272,True
163,64,2005-07-15,charlie and the chocolate factory,150000000,206459076,475825484,325825484,True
164,65,2007-06-29,ratatouille,150000000,206445654,626549695,476549695,True
165,66,2013-11-08,thor: the dark world,150000000,206362140,644602516,494602516,True
166,67,2005-06-15,batman begins,150000000,205343774,359142722,209142722,True
167,68,2015-07-31,mission: impossibleârogue nation,150000000,195042377,688858992,538858992,True
168,69,2017-07-21,dunkirk,150000000,190068280,499837368,349837368,True
169,70,2011-05-06,thor,150000000,181030624,449326618,299326618,True
170,71,2008-11-07,madagascar: escape 2 africa,150000000,180174880,599680774,449680774,True
171,72,2009-05-01,x-men origins: wolverine,150000000,179883157,374825760,224825760,True
172,73,2009-05-22,night at the museum: battle of the smithsonian,150000000,177243721,402231063,252231063,True
173,74,2011-05-26,kung fu panda 2,150000000,165249063,664837547,514837547,True
174,75,2015-05-15,mad max: fury road,150000000,153636354,370098020,220098020,True
175,76,2019-05-10,pokã©mon: detective pikachu,150000000,139507806,411258433,261258433,False
176,77,2003-11-05,the matrix revolutions,150000000,139270910,427300260,277300260,False
177,78,2018-03-29,ready player one,150000000,137690172,579290136,429290136,False
178,79,2005-11-04,chicken little,150000000,135386665,310043823,160043823,False
179,80,2006-05-05,mission: impossible iii,150000000,133501348,397501348,247501348,False
180,81,2009-05-15,angels & demons,150000000,133375846,490875846,340875846,False
181,82,2004-05-14,troy,150000000,133298577,484161265,334161265,False
182,83,2010-07-01,the last airbender,150000000,131772187,319713881,169713881,False
183,84,2007-11-02,bee movie,150000000,126631277,287594577,137594577,False
184,85,2009-07-24,g-force,150000000,119436770,292817841,142817841,False
185,86,2008-11-21,bolt,150000000,114053579,328015029,178015029,False
186,87,2012-03-30,wrath of the titans,150000000,83670083,305270083,155270083,False
187,88,2007-11-16,beowulf,150000000,82280579,195080579,45080579,False
188,89,2012-05-11,dark shadows,150000000,79727149,238202668,88202668,False
189,90,2013-06-28,white house down,150000000,73103784,205440387,55440387,False
190,91,2010-02-12,the wolfman,150000000,62189884,142634358,-7365642,False
191,92,2017-02-17,the great wall,150000000,45157105,334486852,184486852,False
192,93,2015-10-09,pan,150000000,35088320,151525973,1525973,False
193,94,2011-03-11,mars needs moms,150000000,21392758,39549758,-110450242,False
194,95,2020-12-31,moonfall,150000000,0,0,-150000000,False
195,96,2006-11-03,flushed away,149000000,64665672,179357126,30357126,False
196,97,2012-06-08,madagascar 3: europe's most wanted,145000000,216391482,746921271,601921271,True
197,98,2011-12-16,mission: impossibleâghost protocol,145000000,209397903,694713230,549713230,True
198,99,2014-06-13,how to train your dragon 2,145000000,177002924,614586270,469586270,True
199,100,1999-06-16,tarzan,145000000,171091819,448191819,303191819,True
200,1,2014-03-07,mr. peabody & sherman,145000000,111506430,269806430,124806430,False
201,2,2012-11-21,rise of the guardians,145000000,103412758,306900902,161900902,False
202,3,2005-04-08,sahara,145000000,68671925,121671925,-23328075,False
203,4,2016-07-15,ghostbusters,144000000,128350574,229008658,85008658,False
204,5,2002-11-22,die another day,142000000,160942139,431942139,289942139,True
205,6,2003-07-09,pirates of the caribbean: the curse of the black pearl,140000000,305411224,634954103,494954103,True
206,7,2009-05-08,star trek,140000000,257730019,386839614,246839614,True
207,8,1998-07-01,armageddon,140000000,201578182,554600000,414600000,True
208,9,2002-07-03,men in black 2,140000000,190418803,441767803,301767803,True
209,10,2011-07-22,captain america: the first avenger,140000000,176654505,370569776,230569776,True
210,11,2016-01-29,kung fu panda 3,140000000,143528619,517599142,377599142,True
211,12,1998-07-10,lethal weapon 4,140000000,130444603,285400000,145400000,False
212,13,2013-03-27,g.i. joe: retaliation,140000000,122523060,375740705,235740705,False
213,14,2003-12-05,the last samurai,140000000,111110575,456810575,316810575,False
214,15,2005-12-21,fun with dick and jane,140000000,110550000,203018919,63018919,False
215,16,2014-12-12,exodus: gods and kings,140000000,65014513,268314513,128314513,False
216,17,2016-07-01,the bfg,140000000,55483770,199646680,59646680,False
217,18,2016-02-26,gods of egypt,140000000,31153464,138836756,-1163244,False
218,19,2002-05-03,spider-man,139000000,403706375,821706375,682706375,True
219,20,2009-03-06,watchmen,138000000,107509799,186976250,48976250,False
220,21,2005-07-29,stealth,138000000,32116746,76416746,-61583254,False
221,22,2008-06-13,the incredible hulk,137500000,134806913,265573859,128073859,False
222,23,2003-06-20,hulk,137000000,132177234,245075434,108075434,False
223,24,2001-07-11,final fantasy: the spirits within,137000000,32131830,85131830,-51868170,False
224,25,2012-11-16,"the twilight saga: breaking dawn, part 2",136200000,292324737,829724737,693524737,True
225,26,2013-03-22,the croods,135000000,187168425,573068425,438068425,True
226,27,2015-12-25,the revenant,135000000,183637894,532938302,397938302,True
227,28,1999-11-19,the world is not enough,135000000,126930660,361730660,226730660,False
228,29,2011-03-04,rango,135000000,123477607,245724600,110724600,False
229,30,2003-11-14,master and commander: the far side of the world,135000000,93926386,212912137,77912137,False
230,31,2013-07-17,turbo,135000000,83028130,286896578,151896578,False
231,32,2016-06-03,teenage mutant ninja turtles: out of the shadows,135000000,82051601,245328374,110328374,False
232,33,2011-11-18,happy feet two,135000000,64006466,157956466,22956466,False
233,34,2006-07-28,miami vice,135000000,63478838,163818556,28818556,False
234,35,2018-11-02,the nutcracker and the four realms,132900000,54858851,170293899,37393899,False
235,36,2005-06-29,war of the worlds,132000000,234280354,606836535,474836535,True
236,37,2014-11-26,penguins of madagascar,132000000,83350911,366942531,234942531,False
237,38,2013-11-22,the hunger games: catching fire,130000000,424668047,864868047,734868047,True
238,39,2004-06-04,harry potter and the prisoner of azkaban,130000000,249757726,796907323,666907323,True
239,40,2007-08-03,the bourne ultimatum,130000000,227471070,444043396,314043396,True
240,41,2018-07-06,ant-man and the wasp,130000000,216648740,623144660,493144660,True
241,42,2008-06-06,kung fu panda,130000000,215434591,631910531,501910531,True
242,43,2015-07-17,ant-man,130000000,180202163,518858449,388858449,True
243,44,2015-03-27,home,130000000,177397510,385997896,255997896,True
244,45,2018-12-19,mary poppins returns,130000000,171958438,341528518,211528518,True
245,46,2011-10-28,puss in boots,130000000,149260504,554987477,424987477,True
246,47,2010-11-05,megamind,130000000,148415853,321887208,191887208,True
247,48,2003-07-18,bad boys ii,130000000,138540870,273271982,143271982,True
248,49,2014-04-11,rio 2,130000000,131538435,492846291,362846291,True
249,50,2010-07-23,salt,130000000,118311368,290650494,160650494,False
250,51,2014-03-28,noah,130000000,101200044,352831065,222831065,False
251,52,2011-12-21,the adventures of tintin,130000000,77591831,373993951,243993951,False
252,53,2013-05-31,after earth,130000000,60522097,251499665,121499665,False
253,54,2008-11-26,australia,130000000,49554002,215080810,85080810,False
254,55,2013-07-19,r.i.p.d.,130000000,33618855,79076678,-50923322,False
255,56,2019-02-22,how to train your dragon: the hidden world,129000000,160791800,519258283,390258283,True
256,57,2011-11-18,"the twilight saga: breaking dawn, part 1",127500000,281287133,689420051,561920051,True
257,58,2000-05-19,dinosaur,127500000,137748063,356148063,228648063,True
258,59,2017-03-03,logan,127000000,226277068,615461394,488461394,True
259,60,2014-12-19,night at the museum: secret of the tomb,127000000,113746621,353756621,226756621,False
260,61,2011-07-15,harry potter and the deathly hallows: part ii,125000000,381193157,1341693157,1216693157,True
261,62,2014-11-21,the hunger games: mockingjay - part 1,125000000,337135885,766575131,641575131,True
262,63,2001-11-16,harry potter and the sorcererâs stone,125000000,317871467,975047606,850047606,True
263,64,2010-11-19,harry potter and the deathly hallows: part i,125000000,296131568,960431568,835431568,True
264,65,2006-05-19,the da vinci code,125000000,217536138,767820459,642820459,True
265,66,2003-05-02,x-men 2,125000000,214949694,406875536,281875536,True
266,67,2011-04-29,fast five,125000000,210031325,630163454,505163454,True
267,68,2014-08-08,teenage mutant ninja turtles,125000000,191204754,485004754,360004754,True
268,69,2011-12-16,sherlock holmes: a game of shadows,125000000,186848418,535663443,410663443,True
269,70,2004-05-28,the day after tomorrow,125000000,186740799,556319450,431319450,True
270,71,2017-03-31,the boss baby,125000000,175003033,510878762,385878762,True
271,72,2010-04-01,clash of the titans,125000000,163214888,493214888,368214888,True
272,73,2016-11-04,trolls,125000000,153707064,344150134,219150134,True
273,74,1998-05-19,godzilla,125000000,136314294,376000000,251000000,True
274,75,2012-06-08,prometheus,125000000,126477084,402448265,277448265,True
275,76,2012-08-10,the bourne legacy,125000000,113203870,280355920,155355920,False
276,77,1997-06-20,batman & robin,125000000,107325195,238317814,113317814,False
277,78,2018-07-13,skyscraper,125000000,68420120,304115534,179115534,False
278,79,2012-08-03,total recall,125000000,58877969,211856088,86856088,False
279,80,2016-12-21,assassinâs creed,125000000,54647948,240759682,115759682,False
280,81,2017-01-13,monster trucks,125000000,33370166,61642798,-63357202,False
281,82,1999-08-27,the 13th warrior,125000000,32698899,61698899,-63301101,False
282,83,2000-11-17,how the grinch stole christmas,123000000,260044825,345141403,222141403,True
283,84,2000-05-24,mission: impossible 2,120000000,215409889,549588516,429588516,True
284,85,2000-06-30,the perfect storm,120000000,182618434,328711434,208711434,True
285,86,2016-07-29,jason bourne,120000000,162192920,416168316,296168316,True
286,87,2007-06-15,fantastic four: rise of the silver surfer,120000000,131921738,289480691,169480691,True
287,88,2012-11-21,life of pi,120000000,124987022,620912003,500912003,True
288,89,2007-02-16,ghost rider,120000000,115802596,229545589,109545589,False
289,90,2018-04-13,rampage,120000000,101028233,428056280,308056280,False
290,91,2003-06-27,charlie's angels: full throttle,120000000,100814328,227200000,107200000,False
291,92,2013-08-09,elysium,120000000,93050117,286192091,166192091,False
292,93,2013-04-19,oblivion,120000000,89107235,287916633,167916633,False
293,94,2017-03-24,power rangers,120000000,85364450,142531552,22531552,False
294,95,2002-07-19,stuart little 2,120000000,64956806,166000000,46000000,False
295,96,2014-02-12,robocop,120000000,58607007,242981799,122981799,False
296,97,2004-06-11,the chronicles of riddick,120000000,57712751,107212751,-12787249,False
297,98,2015-08-07,fantastic four,120000000,56117548,167849187,47849187,False
298,99,2008-05-09,speed racer,120000000,43945766,93394462,-26605538,False
299,100,2005-07-22,the island,120000000,35818913,163018913,43018913,False
300,1,2010-12-17,how do you know?,120000000,30212620,49628177,-70371823,False
301,2,2010-06-23,knight and day,117000000,76423035,258751370,141751370,False
302,3,2018-10-05,venom,116000000,213511408,853628605,737628605,True
303,4,1999-05-19,star wars ep. i: the phantom menace,115000000,474544677,1027044677,912044677,True
304,5,2005-05-19,star wars ep. iii: revenge of the sith,115000000,380270577,848998877,733998877,True
305,6,2002-05-16,star wars ep. ii: attack of the clones,115000000,310676740,656695615,541695615,True
306,7,2001-11-02,"monsters, inc.",115000000,289423425,559757719,444757719,True
307,8,2013-07-26,the wolverine,115000000,132556852,416456852,301456852,True
308,9,1997-02-07,dante's peak,115000000,67163857,178200000,63200000,False
309,10,2016-04-22,the huntsman: winterâs war,115000000,48003015,165149302,50149302,False
310,11,2002-06-14,windtalkers,115000000,40914068,77628265,-37371735,False
311,12,2008-07-04,astã©rix aux jeux olympiques,113500000,999811,132999811,19499811,False
312,13,2010-12-25,gulliver's travels,112000000,42779261,232017848,120017848,False
313,14,2017-12-15,ferdinand,111000000,84410380,289847930,178847930,False
314,15,2018-05-18,deadpool 2,110000000,324591735,786680557,676680557,True
315,16,2013-10-04,gravity,110000000,274092705,693698673,583698673,True
316,17,2006-12-22,night at the museum,110000000,250863268,579446407,469446407,True
317,18,2005-06-10,mr. and mrs. smith,110000000,186336279,486124090,376124090,True
318,19,2015-05-29,san andreas,110000000,155190832,456258539,346258539,True
319,20,2011-07-29,the smurfs,110000000,142614158,563749323,453749323,True
320,21,2007-06-27,live free or die hard,110000000,134529403,382288147,272288147,True
321,22,2015-03-20,the divergent series: insurgent,110000000,130179072,295075882,185075882,True
322,23,2004-12-10,ocean's twelve,110000000,125531634,362989076,252989076,True
323,24,1997-12-19,tomorrow never dies,110000000,125304276,339504276,229504276,True
324,25,2000-06-28,the patriot,110000000,113330342,215300000,105300000,True
325,26,2014-03-07,300: rise of an empire,110000000,106580051,330780051,220780051,False
326,27,2004-12-17,the aviator,110000000,102608827,208370892,98370892,False
327,28,2016-12-21,passengers,110000000,100014699,302239672,192239672,False
328,29,2011-01-14,the green hornet,110000000,98780042,229155503,119155503,False
329,30,2016-09-30,miss peregrineâs home for peculiar children,110000000,87242834,295986876,185986876,False
330,31,2011-10-07,real steel,110000000,85463309,263880341,153880341,False
331,32,2010-06-11,the a-team,110000000,77222099,177241171,67241171,False
332,33,2013-07-31,the smurfs 2,110000000,71017784,348547523,238547523,False
333,34,2016-03-18,the divergent series: allegiant,110000000,66184051,172022517,62022517,False
334,35,2009-06-12,the taking of pelham 123,110000000,65452312,152364370,42364370,False
335,36,2013-11-01,ender's game,110000000,61737191,127983283,17983283,False
336,37,2004-04-02,home on the range,110000000,50026353,76482461,-33517539,False
337,38,1997-06-13,speed 2: cruise control,110000000,48097081,150468000,40468000,False
338,39,2005-05-06,kingdom of heaven,110000000,47398413,218853353,108853353,False
339,40,2017-03-31,ghost in the shell,110000000,40563557,167910690,57910690,False
340,41,2004-06-16,around the world in 80 days,110000000,24004159,72004159,-37995841,False
341,42,2019-06-14,men in black: international,110000000,3100000,3100000,-106900000,False
342,43,2001-12-19,the lord of the rings: the fellowship of the ring,109000000,315544750,887210985,778210985,True
343,44,2003-11-21,the cat in the hat,109000000,101018283,133818283,24818283,False
344,45,2001-12-25,ali,109000000,58183966,87683966,-21316034,False
345,46,2015-10-02,the martian,108000000,228433663,655271443,547271443,True
346,47,2016-11-23,allied,106000000,40098064,119266661,13266661,False
347,48,2004-07-16,"i, robot",105000000,144801023,348629585,243629585,True
348,49,1999-12-17,stuart little,105000000,140015224,298815224,193815224,True
349,50,2009-11-25,the princess and the frog,105000000,104400899,270997378,165997378,False
350,51,2008-03-07,"10,000 b.c.",105000000,94784201,269065678,164065678,False
351,52,2016-07-22,ice age: collision course,105000000,64063008,402156682,297156682,False
352,53,2001-04-27,town & country,105000000,6712451,10364769,-94635231,False
353,54,2017-09-22,kingsman: the golden circle,104000000,100234838,408803696,304803696,False
354,55,2000-06-09,gone in 60 seconds,103300000,101643008,232643008,129343008,False
355,56,2000-05-05,gladiator,103000000,187683805,457683805,354683805,True
356,57,2013-05-23,the hangover 3,103000000,112200072,362000072,259000072,True
357,58,2018-03-09,a wrinkle in time,103000000,100478608,133401882,30401882,False
358,59,2009-07-01,public enemies,102500000,97104620,212282709,109782709,False
359,60,2006-11-17,casino royale,102000000,167365000,594420283,492420283,True
360,61,2002-06-21,minority report,102000000,132024714,358824714,256824714,True
361,62,2018-12-21,bumblebee,102000000,127195589,465195589,363195589,True
362,63,2012-10-26,cloud atlas,102000000,27108272,130673154,28673154,False
363,64,2002-11-15,harry potter and the chamber of secrets,100000000,262233381,879225135,779225135,True
364,65,1991-07-02,terminator 2: judgment day,100000000,203464105,515419827,415419827,True
365,66,1995-06-16,batman forever,100000000,184031112,336529144,236529144,True
366,67,2001-07-27,planet of the apes,100000000,180011740,362211740,262211740,True
367,68,2004-11-19,national treasure,100000000,173005002,331323410,231323410,True
368,69,2012-12-25,django unchained,100000000,162805434,449948323,349948323,True
369,70,2010-12-22,little fockers,100000000,148438600,310650574,210650574,True
370,71,1994-07-15,true lies,100000000,146282411,365300000,265300000,True
371,72,2007-11-02,american gangster,100000000,130164645,267985456,167985456,True
372,73,2009-09-18,cloudy with a chance of meatballs,100000000,124870275,236827677,136827677,True
373,74,2010-08-06,the other guys,100000000,119219978,170936470,70936470,True
374,75,2004-12-17,lemony snicket's a series of unfortunate events,100000000,118627117,212956024,112956024,True
375,76,2013-12-25,the wolf of wall street,100000000,116900694,389870414,289870414,True
376,77,2013-05-24,epic,100000000,107518682,262794441,162794441,True
377,78,1996-06-21,eraser,100000000,101295562,234400000,134400000,True
378,79,1996-06-21,the hunchback of notre dame,100000000,100138851,325500000,225500000,True
379,80,2000-12-15,the emperor's new groove,100000000,89296573,169296573,69296573,False
380,81,2012-08-17,the expendables 2,100000000,85028192,311979256,211979256,False
381,82,2009-10-16,where the wild things are,100000000,77233467,99123656,-876344,False
382,83,2006-12-15,eragon,100000000,75030163,249488115,149488115,False
383,84,2014-07-25,hercules,100000000,72688614,243388614,143388614,False
384,85,2010-12-10,the tourist,100000000,67631157,278731369,178731369,False
385,86,1999-11-24,end of days,100000000,66889043,212026975,112026975,False
386,87,2004-06-11,the stepford wives,100000000,59475623,96221971,-3778029,False
387,88,2007-06-08,surf's up,100000000,58867694,145395745,45395745,False
388,89,2006-12-08,blood diamond,100000000,57377916,171377916,71377916,False
389,90,2010-09-24,legend of the guardians: the owls of ga'hoole,100000000,55675313,139716717,39716717,False
390,91,1997-11-07,starship troopers,100000000,54768952,121100000,21100000,False
391,92,2009-06-05,land of the lost,100000000,49438370,69548641,-30451359,False
392,93,2003-12-25,peter pan,100000000,48417850,95255485,-4744515,False
393,94,2019-03-15,wonder park,100000000,45216793,115149422,15149422,False
394,95,2004-07-23,catwoman,100000000,40202379,82145379,-17854621,False
395,96,2014-08-15,the expendables 3,100000000,39322544,209461378,109461378,False
396,97,2002-11-27,treasure planet,100000000,38120554,91800000,-8200000,False
397,98,2010-03-12,green zone,100000000,35497337,97523020,-2476980,False
398,99,2017-10-20,geostorm,100000000,33700160,220796009,120796009,False
399,100,2015-12-25,point break,100000000,28782481,126704591,26704591,False
400,1,2015-12-11,in the heart of the sea,100000000,25020758,89693309,-10306691,False
401,2,2014-04-18,transcendence,100000000,23022309,103039258,3039258,False
402,3,2005-02-18,son of the mask,100000000,17018422,59918422,-40081578,False
403,4,2018-12-14,mortal engines,100000000,15951040,85287417,-14712583,False
404,5,2002-08-16,the adventures of pluto nash,100000000,4411102,7094995,-92905005,False
405,6,2012-01-20,jin lã­ng shã­ san chai,100000000,311434,98227017,-1772983,False
406,7,2015-11-06,the peanuts movie,99000000,130178411,250091610,151091610,True
407,8,2019-02-08,the lego movie 2: the second part,99000000,105806508,190325698,91325698,True
408,9,2018-11-21,robin hood,99000000,30824628,84747441,-14252559,False
409,10,2001-05-04,the mummy returns,98000000,202007640,435040395,337040395,True
410,11,2002-12-20,gangs of new york,97000000,77730500,183124621,86124621,False
411,12,2017-05-19,alien: covenant,97000000,74262031,238521247,141521247,False
412,13,2015-03-13,cinderella,95000000,201151353,534551353,439551353,True
413,14,2012-07-13,ice age: continental drift,95000000,161321843,879765137,784765137,True
414,15,2001-12-28,black hawk down,95000000,108638745,159691085,64691085,True
415,16,2010-05-27,sex and the city 2,95000000,95347692,294680778,199680778,True
416,17,2010-02-12,percy jackson & the olympians: the lightning thief,95000000,88768303,223050874,128050874,False
417,18,2012-08-10,the campaign,95000000,86907746,104907746,9907746,False
418,19,2010-11-12,unstoppable,95000000,81562942,165720921,70720921,False
419,20,1997-05-09,the fifth element,95000000,63570862,263898761,168898761,False
420,21,2000-03-31,the road to el dorado,95000000,50802661,65700000,-29300000,False
421,22,2009-12-11,the lovely bones,95000000,44114232,94894448,-105552,False
422,23,2016-08-19,ben-hur,95000000,26410477,91669648,-3330352,False
423,24,2015-02-06,seventh son,95000000,17725785,108874967,13874967,False
424,25,2003-05-30,finding nemo,94000000,380529370,936429370,842429370,True
425,26,2003-12-17,the lord of the rings: the return of the king,94000000,377845905,1141403341,1047403341,True
426,27,2002-12-18,the lord of the rings: the two towers,94000000,342548984,934699645,840699645,True
427,28,2001-06-15,lara croft: tomb raider,94000000,131144183,273330185,179330185,True
428,29,2015-02-13,kingsman: the secret service,94000000,128261724,404561724,310561724,True
429,30,2001-07-18,jurassic park iii,93000000,181166115,365900000,272900000,True
430,31,2011-08-05,rise of the planet of the apes,93000000,176760185,470986200,377986200,True
431,32,2008-02-14,the spiderwick chronicles,92500000,71195053,162839667,70339667,False
432,33,2004-11-05,the incredibles,92000000,261441092,614726752,522726752,True
433,34,2013-02-14,a good day to die hard,92000000,67349198,304249198,212249198,False
434,35,2004-04-09,the alamo,92000000,22406362,23911362,-68088638,False
435,36,1995-12-22,cutthroat island,92000000,10017322,18517322,-73482678,False
436,37,2013-12-25,the secret life of walter mitty,91000000,58236838,187861183,96861183,False
437,38,2017-12-20,jumanji: welcome to the jungle,90000000,404508916,964496193,874496193,True
438,39,1997-07-01,men in black,90000000,250690539,587790539,497790539,True
439,40,1999-11-19,toy story 2,90000000,245852179,511358276,421358276,True
440,41,2001-08-03,rush hour 2,90000000,226164286,347425832,257425832,True
441,42,2009-12-25,sherlock holmes,90000000,209028679,498438212,408438212,True
442,43,2009-07-01,ice age: dawn of the dinosaurs,90000000,196573705,859701857,769701857,True
443,44,2018-12-14,spider-man: into the spider-verse 3d,90000000,190173195,375381768,285381768,True
444,45,2000-07-21,what lies beneath,90000000,155464351,288693989,198693989,True
445,46,2011-04-15,rio,90000000,143619809,487519809,397519809,True
446,47,2006-10-06,the departed,90000000,132384315,289660619,199660619,True
447,48,2000-11-03,charlie's angels,90000000,125305545,259736090,169736090,True
448,49,1998-06-19,mulan,90000000,120620254,303500000,213500000,True
449,50,2008-08-13,tropic thunder,90000000,110515313,191145256,101145256,True
450,51,2011-12-20,the girl with the dragon tattoo,90000000,102515793,239373970,149373970,True
451,52,1997-07-11,contact,90000000,100920329,165900000,75900000,True
452,53,2008-06-06,you don't mess with the zohan,90000000,100018837,202910991,112910991,True
453,54,1995-05-19,die hard: with a vengeance,90000000,100012499,366101666,276101666,True
454,55,2016-09-23,the magnificent seven,90000000,93432655,162525156,72525156,True
455,56,2015-12-18,alvin and the chipmunks: the road chip,90000000,85886987,249517956,159517956,False
456,57,2001-06-08,atlantis: the lost empire,90000000,84052762,186049020,96049020,False
457,58,2008-12-25,valkyrie,90000000,83107829,203932174,113932174,False
458,59,2015-07-24,pixels,90000000,78765986,244041804,154041804,False
459,60,2001-06-29,artificial intelligence: ai,90000000,78616689,235900000,145900000,False
460,61,2003-11-26,the haunted mansion,90000000,75817994,155750628,65750628,False
461,62,2000-08-04,hollow man,90000000,73209340,191200000,101200000,False
462,63,2005-04-22,the interpreter,90000000,72708161,162753837,72753837,False
463,64,2013-08-07,percy jackson: sea of monsters,90000000,68559554,200859554,110859554,False
464,65,2003-07-25,lara croft: tomb raider: the cradle of life,90000000,65653758,157092943,67092943,False
465,66,2016-06-10,now you see me 2,90000000,65075540,328325007,238325007,False
466,67,2001-11-21,spy game,90000000,62362560,143049560,53049560,False
467,68,1997-04-04,the saint,90000000,61363304,169400000,79400000,False
468,69,2000-03-10,mission to mars,90000000,60874615,106000000,16000000,False
469,70,2018-03-16,tomb raider,90000000,58250803,273477501,183477501,False
470,71,1999-12-17,bicentennial man,90000000,58220776,87420776,-2579224,False
471,72,2004-07-07,king arthur,90000000,51877963,203877963,113877963,False
472,73,1997-04-25,volcano,90000000,47546796,120100000,30100000,False
473,74,1997-03-26,the devil's own,90000000,42885593,140900000,50900000,False
474,75,2002-07-19,k-19: the widowmaker,90000000,35168966,65716126,-24283874,False
475,76,2011-08-19,conan the barbarian,90000000,21295021,63356133,-26643867,False
476,77,2011-10-21,the three musketeers,90000000,20377913,139877913,49877913,False
477,78,2017-04-21,the promise,90000000,8224288,10551417,-79448583,False
478,79,2010-11-24,the nutcracker in 3d,90000000,195459,20466016,-69533984,False
479,80,2017-12-13,bright,90000000,0,0,-90000000,False
480,81,2019-12-31,army of the dead,90000000,0,0,-90000000,False
481,82,1996-05-10,twister,88000000,241688385,495700000,407700000,True
482,83,2005-06-03,cinderella man,88000000,61649911,105021488,17021488,False
483,84,2018-09-14,the predator,88000000,51024708,159487563,71487563,False
484,85,2005-07-08,fantastic four,87500000,154696080,333132750,245632750,True
485,86,2001-02-09,hannibal,87000000,165092266,350100280,263100280,True
486,87,2003-07-25,seabiscuit,86000000,120277854,148715342,62715342,True
487,88,2000-12-22,cast away,85000000,233632142,427230516,342230516,True
488,89,2006-11-17,happy feet,85000000,198000317,385000317,300000317,True
489,90,2001-12-07,ocean's eleven,85000000,183417150,450728529,365728529,True
490,91,2004-07-23,the bourne supremacy,85000000,176087450,311001124,226001124,True
491,92,1997-07-25,air force one,85000000,172956409,315268353,230268353,True
492,93,2009-04-03,fast & furious,85000000,155064265,363064265,278064265,True
493,94,2008-03-14,horton hears a who,85000000,154529439,299477886,214477886,True
494,95,2014-03-21,divergent,85000000,150947895,276014965,191014965,True
495,96,2012-09-28,hotel transylvania,85000000,148313048,378505812,293505812,True
496,97,2019-04-05,shazam!,85000000,139606856,362899733,277899733,True
497,98,2007-11-21,enchanted,85000000,127706877,340384141,255384141,True
498,99,2012-02-10,safe house,85000000,126181630,208542162,123542162,True
499,100,2007-07-20,i now pronounce you chuck and larry,85000000,119725280,185708462,100708462,True
500,1,2007-06-08,ocean's thirteen,85000000,117144465,311744465,226744465,True
501,2,2009-12-25,itâs complicated,85000000,112735375,224614744,139614744,True
502,3,1998-11-20,enemy of the state,85000000,111549836,250649836,165649836,True
503,4,2006-09-29,open season,85000000,85105259,191932158,106932158,True
504,5,2011-11-04,tower heist,85000000,78046570,150422946,65422946,False
505,6,2000-11-22,102 dalmatians,85000000,66941559,66941559,-18058441,False
506,7,2012-03-30,mirror mirror,85000000,64935167,173613482,88613482,False
507,8,2006-12-08,the holiday,85000000,63280000,205190324,120190324,False
508,9,2006-06-16,the fast and the furious: tokyo drift,85000000,62615510,157794205,72794205,False
509,10,2005-12-09,memoirs of a geisha,85000000,57010853,161510853,76510853,False
510,11,2001-03-16,enemy at the gates,85000000,51396781,96971293,11971293,False
511,12,1993-06-18,last action hero,85000000,50016394,137298489,52298489,False
512,13,2003-09-26,the rundown,85000000,47641743,80831893,-4168107,False
513,14,2011-11-23,arthur christmas,85000000,46462469,149717124,64717124,False
514,15,2017-01-20,xxx: return of xander cage,85000000,44898413,345033359,260033359,False
515,16,1998-11-13,meet joe black,85000000,44650003,44650003,-40349997,False
516,17,2010-07-30,cats & dogs: the revenge of kitty galore,85000000,43585753,113026383,28026383,False
517,18,2002-02-08,collateral damage,85000000,40048332,78353508,-6646492,False
518,19,2002-03-15,showtime,85000000,37948765,78948765,-6051235,False
519,20,1995-06-30,judge dredd,85000000,34687912,113487912,28487912,False
520,21,2007-03-02,zodiac,85000000,33080084,83080084,-1919916,False
521,22,2010-08-13,scott pilgrim vs. the world,85000000,31611316,48056764,-36943236,False
522,23,2003-03-28,the core,85000000,31111260,74132631,-10867369,False
523,24,1997-05-09,father's day,85000000,28681080,35681080,-49318920,False
524,25,2017-12-20,the greatest showman,84000000,174340174,386665550,302665550,True
525,26,2002-06-14,scooby-doo,84000000,153294164,276294164,192294164,True
526,27,2000-07-28,nutty professor ii: the klumps,84000000,123307945,166307945,82307945,True
527,28,2013-07-19,red 2,84000000,53262560,141507355,57507355,False
528,29,2006-06-23,click,82500000,137355633,237685089,155185089,True
529,30,2006-12-15,charlotte's web,82500000,82985708,143985708,61485708,True
530,31,2008-02-14,jumper,82500000,80172128,222640812,140140812,False
531,32,2008-07-11,hellboy ii: the golden army,82500000,75986503,160388063,77888063,False
532,33,2005-05-27,the longest yard,82000000,158119460,191558505,109558505,True
533,34,2010-08-13,the expendables,82000000,103068524,268268174,186268174,True
534,35,2000-11-17,the 6th day,82000000,34543701,96024898,14024898,False
535,36,2020-02-21,call of the wild,82000000,0,0,-82000000,False
536,37,2003-05-23,bruce almighty,81000000,242704995,484468608,403468608,True
537,38,2012-03-23,the hunger games,80000000,408010692,677923379,597923379,True
538,39,2011-05-26,the hangover part ii,80000000,254464305,586464305,506464305,True
539,40,1996-05-21,mission: impossible,80000000,180981886,457697994,377697994,True
540,41,2017-02-10,the lego batman movie,80000000,175750384,310660018,230660018,True
541,42,2015-09-25,hotel transylvania 2,80000000,169700110,469500298,389500298,True
542,43,1992-06-18,batman returns,80000000,162833635,266824291,186824291,True
543,44,1999-05-07,the mummy,80000000,155385488,416385488,336385488,True
544,45,2006-05-19,over the hedge,80000000,155019340,343397247,263397247,True
545,46,2002-06-21,lilo & stitch,80000000,145771527,245800000,165800000,True
546,47,1998-05-08,deep impact,80000000,140464664,349464664,269464664,True
547,48,2013-07-12,grown ups 2,80000000,133668525,247023808,167023808,True
548,49,2011-12-16,alvin and the chipmunks: chipwrecked,80000000,133107389,349088523,269088523,True
549,50,2008-06-20,get smart,80000000,130319208,226739416,146739416,True
550,51,2005-03-11,robots,80000000,128200012,260700012,180700012,True
551,52,2010-02-19,shutter island,80000000,128012934,299461782,219461782,True
552,53,2003-12-12,something's gotta give,80000000,124685242,266685242,186685242,True
553,54,2008-11-26,four christmases,80000000,120146040,168311558,88311558,True
554,55,1997-06-27,face/off,80000000,112276146,241200000,161200000,True
555,56,2008-12-25,bedtime stories,80000000,110101975,221468935,141468935,True
556,57,2002-07-12,road to perdition,80000000,104054514,183354514,103354514,True
557,58,2011-02-11,just go with it,80000000,103028109,214974953,134974953,True
558,59,2003-02-14,daredevil,80000000,102543518,182782518,102782518,True
559,60,2008-09-26,eagle eye,80000000,101440743,180585259,100585259,True
560,61,1997-06-06,con air,80000000,101117573,224117573,144117573,True
561,62,2010-12-17,yogi bear,80000000,100246011,204774690,124774690,True
562,63,2003-12-25,cold mountain,80000000,95632614,165173909,85173909,True
563,64,2010-01-15,the book of eli,80000000,94835059,158750817,78750817,True
564,65,1997-11-26,flubber,80000000,92993801,177993801,97993801,True
565,66,1999-07-23,the haunting,80000000,91188905,180188905,100188905,True
566,67,1996-11-15,space jam,80000000,90463534,250200000,170200000,True
567,68,2014-10-17,fury,80000000,85817906,210315681,130315681,True
568,69,2018-09-28,smallfoot,80000000,83240103,213691277,133691277,True
569,70,2006-02-10,the pink panther,80000000,82226474,158926474,78926474,True
570,71,2011-07-08,zookeeper,80000000,80360866,170805525,90805525,True
571,72,2008-12-12,the day the earth stood still,80000000,79366978,237370350,157370350,False
572,73,1997-08-08,conspiracy theory,80000000,76118990,142783718,62783718,False
573,74,1998-06-12,"six days, seven nights",80000000,74339294,164800000,84800000,False
574,75,2002-05-24,spirit: stallion of the cimarron,80000000,73215310,106515310,26515310,False
575,76,2001-06-08,swordfish,80000000,69772969,147080413,67080413,False
576,77,1999-12-31,fantasia 2000 (theatrical release),80000000,69610858,69618634,-10381366,False
577,78,1998-04-03,lost in space,80000000,69117629,136047317,56047317,False
578,79,2004-07-30,the manchurian candidate,80000000,65948711,96148711,16148711,False
579,80,2006-11-22,dã©jã vu,80000000,64038616,181038616,101038616,False
580,81,2019-06-07,the secret life of pets 2,80000000,63795655,113351496,33351496,False
581,82,2005-06-24,bewitched,80000000,63313159,131159306,51159306,False
582,83,2002-03-08,the time machine,80000000,56684819,98983590,18983590,False
583,84,1998-10-02,what dreams may come,80000000,55485043,71485043,-8514957,False
584,85,1998-12-25,mighty joe young,80000000,50632037,50632037,-29367963,False
585,86,2005-10-28,the legend of zorro,80000000,45575336,141475336,61475336,False
586,87,2000-11-10,little nicky,80000000,39442871,58270391,-21729609,False
587,88,2009-09-25,surrogates,80000000,38577772,119668350,39668350,False
588,89,2001-06-08,evolution,80000000,38311134,98341932,18341932,False
589,90,2005-08-26,the brothers grimm,80000000,37899638,105299638,25299638,False
590,91,1996-12-13,mars attacks!,80000000,37771017,101371017,21371017,False
591,92,2006-04-14,the wild,80000000,37384046,99010667,19010667,False
592,93,2013-12-20,walking with dinosaurs,80000000,36076121,123368842,43368842,False
593,94,2000-12-22,thirteen days,80000000,34566746,66554547,-13445453,False
594,95,1996-12-06,daylight,80000000,32908290,158908290,78908290,False
595,96,2015-10-23,the last witch hunter,80000000,27367660,130818912,50818912,False
596,97,2014-02-21,pompeii,80000000,23169033,108469033,28469033,False
597,98,2000-05-12,battlefield earth: a saga of the year 3000,80000000,21471685,29725663,-50274337,False
598,99,2003-11-14,looney tunes: back in action,80000000,20950820,54540662,-25459338,False
599,100,2009-12-18,nine,80000000,19676965,53508858,-26491142,False
600,1,2003-11-26,timeline,80000000,19480739,26703184,-53296816,False
601,2,2010-04-22,oceans,80000000,19422319,86787530,6787530,False
602,3,1998-11-25,babe: pig in the city,80000000,18319860,69131860,-10868140,False
603,4,1997-12-25,the postman,80000000,17650704,20841123,-59158877,False
604,5,2000-11-10,red planet,80000000,17480890,33463969,-46536031,False
605,6,2007-01-12,arthur et les minimoys,80000000,15132763,113325743,33325743,False
606,7,2007-08-17,the invasion,80000000,15074191,40147042,-39852958,False
607,8,2005-09-02,a sound of thunder,80000000,1900451,6300451,-73699549,False
608,9,1994-06-15,the lion king,79300000,421785283,986214868,906914868,True
609,10,2012-02-10,journey 2: the mysterious island,79000000,103860290,318146162,239146162,True
610,11,2011-11-11,jack and jill,79000000,74158157,150519217,71519217,False
611,12,2001-12-21,a beautiful mind,78000000,170708996,317668058,239668058,True
612,13,2013-09-27,cloudy with a chance of meatballs 2,78000000,119793567,274392649,196392649,True
613,14,2002-10-04,red dragon,78000000,92955420,206455420,128455420,True
614,15,2004-03-05,hidalgo,78000000,67286731,108086731,30086731,False
615,16,2003-07-11,the league of extraordinary gentlemen,78000000,66465204,179265204,101265204,False
616,17,2004-08-20,exorcist: the beginning,78000000,41814863,43957541,-34042459,False
617,18,2012-12-31,astã©rix et obã©lix: au service de sa majestã©,77600000,0,60680125,-16919875,False
618,19,2016-02-12,the little prince,77500000,1311213,102028919,24528919,False
619,20,2019-01-22,renegades,77500000,0,1521672,-75978328,False
620,21,2018-07-20,the equalizer 2,77000000,102084362,190453132,113453132,True
621,22,2013-07-03,despicable me 2,76000000,368065385,975216835,899216835,True
622,23,2003-06-06,2 fast 2 furious,76000000,127120058,236410607,160410607,True
623,24,2006-12-25,children of men,76000000,35552383,69845011,-6154989,False
624,25,2000-06-30,the adventures of rocky & bullwinkle,76000000,26000610,35129610,-40870390,False
625,26,2016-07-08,the secret life of pets,75000000,368384330,886750534,811750534,True
626,27,1996-07-02,independence day,75000000,306169255,817400878,742400878,True
627,28,2018-11-09,dr. seussâ the grinch,75000000,270620950,511002426,436002426,True
628,29,2016-12-21,sing,75000000,270329045,634454789,559454789,True
629,30,2017-06-30,despicable me 3,75000000,264624300,1034727750,959727750,True
630,31,1997-05-22,the lost world: jurassic park,75000000,229086679,618638999,543638999,True
631,32,2006-03-31,ice age: the meltdown,75000000,195330621,651899282,576899282,True
632,33,2005-05-27,madagascar,75000000,193595521,556559566,481559566,True
633,34,2010-06-25,grown ups,75000000,162001186,272223430,197223430,True
634,35,2004-10-01,shark tale,75000000,161412000,371917043,296917043,True
635,36,2000-07-14,x-men,75000000,157299717,296872367,221872367,True
636,37,2008-06-27,wanted,75000000,134508551,342416460,267416460,True
637,38,1996-06-07,the rock,75000000,134069511,336069511,261069511,True
638,39,2004-02-13,50 first dates,75000000,120776832,196320329,121320329,True
639,40,2007-07-20,hairspray,75000000,118871849,203035572,128035572,True
640,41,2013-05-31,now you see me,75000000,117723989,342769200,267769200,True
641,42,2006-12-15,dreamgirls,75000000,103365956,155708695,80708695,True
642,43,2018-08-03,christopher robin,75000000,99215042,197504758,122504758,True
643,44,1999-07-23,inspector gadget,75000000,97387965,97387965,22387965,True
644,45,2011-11-11,immortals,75000000,83504017,211562435,136562435,True
645,46,2004-06-18,the terminal,75000000,77073959,218673959,143673959,True
646,47,2005-02-18,constantine,75000000,75976178,221594911,146594911,True
647,48,2006-07-21,monster house,75000000,73661010,141267370,66267370,False
648,49,2000-12-08,vertical limit,75000000,68473360,213500000,138500000,False
649,50,2007-12-21,charlie wilson's war,75000000,66661095,119512771,44512771,False
650,51,1999-04-16,life,75000000,64062587,73521587,-1478413,False
651,52,2005-03-04,be cool,75000000,55849401,94944017,19944017,False
652,53,2005-12-23,munich,75000000,47379090,131492772,56492772,False
653,54,2010-06-04,killers,75000000,47059963,95572749,20572749,False
654,55,2015-08-14,the man from u.n.c.l.e.,75000000,45445109,104949584,29949584,False
655,56,2003-03-07,tears of the sun,75000000,43632458,85632458,10632458,False
656,57,2006-07-21,lady in the water,75000000,42285169,72785169,-2214831,False
657,58,2004-12-17,spanglish,75000000,42044321,54344321,-20655679,False
658,59,2001-10-12,bandits,75000000,41523271,71523271,-3476729,False
659,60,1999-12-17,anna and the king,75000000,39251128,39251128,-35748872,False
660,61,1995-07-07,first knight,75000000,37361412,127361412,52361412,False
661,62,2011-03-25,sucker punch,75000000,36392502,89758389,14758389,False
662,63,2005-03-11,hostage,75000000,34636443,77636443,2636443,False
663,64,2016-10-28,inferno,75000000,34343574,219519367,144519367,False
664,65,2003-06-13,hollywood homicide,75000000,30207785,50409753,-24590247,False
665,66,2000-06-16,titan a.e.,75000000,22751979,36751979,-38248021,False
666,67,2004-12-17,flight of the phoenix,75000000,21009180,34009180,-40990820,False
667,68,1998-10-23,soldier,75000000,14623082,14623082,-60376918,False
668,69,1999-01-15,virus,75000000,14010690,30626690,-44373310,False
669,70,2001-02-23,monkeybone,75000000,5409517,5409517,-69590483,False
670,71,2019-08-30,playmobil,75000000,0,0,-75000000,False
671,72,2019-12-31,355,75000000,0,0,-75000000,False
672,73,2015-07-10,minions,74000000,336045770,1160336173,1086336173,True
673,74,2015-02-06,the spongebob movie: sponge out of water,74000000,162994032,311013181,237013181,True
674,75,2000-11-22,unbreakable,73243106,94999143,248099143,174856037,True
675,76,2006-08-04,talladega nights: the ballad of ricky bobby,73000000,148213377,162870525,89870525,True
676,77,2016-05-20,the angry birds movie,73000000,107509366,352327887,279327887,True
677,78,1998-08-07,snake eyes,73000000,55591409,103891409,30891409,False
678,79,1998-02-13,sphere,73000000,37068294,50168294,-22831706,False
679,80,2007-07-27,the simpsons movie,72500000,183135014,527071022,454571022,True
680,81,2008-02-08,fool's gold,72500000,70231041,109362966,36862966,False
681,82,2009-07-31,funny people,72500000,51855045,71880305,-619695,False
682,83,2007-09-28,the kingdom,72500000,47467250,86509602,14009602,False
683,84,2001-06-22,dr. dolittle 2,72000000,112950721,176101721,104101721,True
684,85,1995-05-24,braveheart,72000000,75545647,209045244,137045244,True
685,86,2005-11-04,jarhead,72000000,62647540,96947540,24947540,False
686,87,2001-04-27,driven,72000000,32616869,54616869,-17383131,False
687,88,2001-12-21,the majestic,72000000,27796042,37306334,-34693666,False
688,89,2004-06-25,two brothers,72000000,19176754,62176754,-9823246,False
689,90,2004-07-30,the village,71682975,114197520,257641634,185958659,True
690,91,1998-06-26,doctor dolittle,71500000,144156605,294156605,222656605,True
691,92,2002-08-02,signs,70702619,227969295,408269295,337566676,True
692,93,2004-05-19,shrek 2,70000000,441226247,937008132,867008132,True
693,94,2006-06-09,cars,70000000,244082982,461651246,391651246,True
694,95,2009-12-23,alvin and the chipmunks: the squeakquel,70000000,219614612,443483213,373483213,True
695,96,1988-06-22,who framed roger rabbit?,70000000,154112492,351500000,281500000,True
696,97,1999-07-30,runaway bride,70000000,152257509,310138178,240138178,True
697,98,2002-08-09,xxx,70000000,141930000,267200000,197200000,True
698,99,2018-06-08,oceanâs 8,70000000,140218711,297115976,227115976,True
699,100,1996-11-08,ransom,70000000,136492681,308700000,238700000,True
700,1,2009-08-21,inglourious basterds,70000000,120774594,316915264,246915264,True
701,2,1991-12-11,hook,70000000,119654823,300854823,230854823,True
702,3,1990-07-03,die hard 2,70000000,117323878,239814025,169814025,True
703,4,2003-08-08,s.w.a.t.,70000000,116877597,207154748,137154748,True
704,5,2017-11-10,daddyâs home 2,70000000,104029443,175807183,105807183,True
705,6,1999-11-19,sleepy hollow,70000000,101068340,207068340,137068340,True
706,7,2001-12-14,vanilla sky,70000000,100614858,202726605,132726605,True
707,8,1997-06-13,hercules,70000000,99112101,250700000,180700000,True
708,9,2013-03-22,olympus has fallen,70000000,98927592,172878928,102878928,True
709,10,2011-03-11,battle: los angeles,70000000,83552429,213463976,143463976,True
710,11,2004-08-13,avp: alien vs. predator,70000000,80281096,172543519,102543519,True
711,12,2011-12-25,war horse,70000000,79883359,156815529,86815529,True
712,13,2002-03-01,we were soldiers,70000000,78120196,114658262,44658262,True
713,14,2014-02-07,the monuments men,70000000,78031620,158702748,88702748,True
714,15,2016-09-23,storks,70000000,72679278,183353431,113353431,True
715,16,1998-12-11,star trek: insurrection,70000000,70187658,117800000,47800000,True
716,17,2003-12-10,big fish,70000000,66432867,123954323,53954323,False
717,18,1994-06-17,wolf,70000000,65011757,131011757,61011757,False
718,19,2012-01-20,underworld: awakening,70000000,62321039,160379930,90379930,False
719,20,2017-09-22,the lego ninjago movie,70000000,59281555,122737201,52737201,False
720,21,2014-10-10,dracula untold,70000000,55991880,220241723,150241723,False
721,22,2006-09-29,the guardian,70000000,55011732,94973540,24973540,False
722,23,1989-08-09,the abyss,70000000,54243125,54243125,-15756875,False
723,24,2010-09-24,wall street 2: money never sleeps,70000000,52474616,137431619,67431619,False
724,25,2011-01-14,the dilemma,70000000,48475290,70546865,546865,False
725,26,2005-12-25,rumor has it,70000000,42996140,88933562,18933562,False
726,27,1998-11-06,the siege,70000000,40934175,116625798,46625798,False
727,28,2007-08-10,stardust,70000000,38634938,137022245,67022245,False
728,29,2012-06-15,rock of ages,70000000,38518613,61031932,-8968068,False
729,30,1997-10-08,seven years in tibet,70000000,37945884,131445884,61445884,False
730,31,2004-09-17,sky captain and the world of tomorrow,70000000,37760080,49730854,-20269146,False
731,32,2007-09-14,the brave one,70000000,36793804,69792704,-207296,False
732,33,2002-11-01,i spy,70000000,33561137,60279822,-9720178,False
733,34,2002-06-07,bad company,70000000,30157016,69157016,-842984,False
734,35,2005-10-21,doom,70000000,28212337,58757178,-11242822,False
735,36,2016-01-29,the finest hours,70000000,27569558,49252761,-20747239,False
736,37,2013-10-18,escape plan,70000000,25135965,103735965,33735965,False
737,38,2011-09-23,killer elite,70000000,25124986,65409046,-4590954,False
738,39,1998-01-16,hard rain,70000000,19870567,19870567,-50129433,False
739,40,2002-02-15,hart's war,70000000,19076815,33076815,-36923185,False
740,41,2002-02-08,rollerball,70000000,18990542,25852508,-44147492,False
741,42,2014-01-10,the legend of hercules,70000000,18848538,58953319,-11046681,False
742,43,2007-04-27,next,70000000,18211013,73591500,3591500,False
743,44,2002-09-20,ballistic: ecks vs. sever,70000000,14294842,14294842,-55705158,False
744,45,2001-08-10,osmosis jones,70000000,13596911,13596911,-56403089,False
745,46,2014-05-09,legends of oz: dorothyâs return,70000000,8462347,20107933,-49892067,False
746,47,2015-01-16,blackhat,70000000,8005980,19665004,-50334996,False
747,48,2006-03-31,basic instinct 2,70000000,5946136,35417162,-34582838,False
748,49,2010-05-28,agora,70000000,619423,38992292,-31007708,False
749,50,2010-07-09,despicable me,69000000,251513985,543464573,474464573,True
750,51,2010-07-30,dinner for schmucks,69000000,73026337,86796502,17796502,True
751,52,2018-03-02,red sparrow,69000000,46874505,145951861,76951861,False
752,53,2010-06-30,the twilight saga: eclipse,68000000,300531751,706102828,638102828,True
753,54,2002-05-31,the sum of all fears,68000000,118471320,193500000,125500000,True
754,55,2015-06-26,ted 2,68000000,81476385,217214143,149214143,True
755,56,2001-07-13,the score,68000000,71069884,113542091,45542091,True
756,57,2011-02-25,hall pass,68000000,45060734,87173475,19173475,False
757,58,1995-11-22,money train,68000000,35324232,77224232,9224232,False
758,59,2003-03-21,dreamcatcher,68000000,33685268,75685268,7685268,False
759,60,1999-08-06,mystery men,68000000,29762011,33462011,-34537989,False
760,61,1999-11-05,the insider,68000000,28965197,60265197,-7734803,False
761,62,2017-12-22,downsizing,68000000,24449754,54462971,-13537029,False
762,63,2012-03-02,doctor seuss' the lorax,67500000,214030500,350976753,283476753,True
763,64,2008-10-10,body of lies,67500000,39394666,118556530,51056530,False
764,65,2012-06-22,abraham lincoln: vampire hunter,67500000,37519139,137489730,69989730,False
765,66,1996-09-20,last man standing,67000000,18115927,18115927,-48884073,False
766,67,2007-08-17,the last legion,67000000,5932060,25357771,-41642229,False
767,68,1999-04-30,entrapment,66000000,87707396,211700000,145700000,True
768,69,1998-06-19,the x files: fight the future,66000000,83898313,189176423,123176423,True
769,70,2014-03-14,need for speed,66000000,43568507,194169619,128169619,False
770,71,1998-07-24,saving private ryan,65000000,216335085,485035085,420035085,True
771,72,2000-12-15,what women want,65000000,182805123,374105123,309105123,True
772,73,2012-11-09,lincoln,65000000,182207973,273346281,208346281,True
773,74,2002-03-15,ice age,65000000,176387405,386116343,321116343,True
774,75,1995-06-30,apollo 13,65000000,173772767,335802271,270802271,True
775,76,1999-03-31,the matrix,65000000,171479930,463517383,398517383,True
776,77,2018-07-13,hotel transylvania 3: summer vacation,65000000,167500092,527079962,462079962,True
777,78,2012-12-25,les miserables,65000000,148809770,442169052,377169052,True
778,79,2002-11-01,the santa clause 2,65000000,139225854,172825854,107825854,True
779,80,1990-06-01,total recall,65000000,119394839,261400000,196400000,True
780,81,1998-12-18,you've got mail,65000000,115821495,250800000,185800000,True
781,82,2014-12-25,unbroken,65000000,115637895,163527824,98527824,True
782,83,2015-06-05,spy!,65000000,110825712,232585748,167585748,True
783,84,2010-11-05,due date,65000000,100539043,211739043,146739043,True
784,85,2008-07-25,step brothers,65000000,100468793,128468793,63468793,True
785,86,1995-12-15,jumanji,65000000,100458310,262758310,197758310,True
786,87,1998-07-17,the mask of zorro,65000000,93828745,233700000,168700000,True
787,88,2000-08-04,space cowboys,65000000,90454043,128874043,63874043,True
788,89,2014-12-19,annie,65000000,85911262,139829625,74829625,True
789,90,1993-05-28,cliffhanger,65000000,84049211,255000000,190000000,True
790,91,2016-08-12,peteâs dragon,65000000,76233151,137768975,72768975,True
791,92,1996-02-09,broken arrow,65000000,70645997,148345997,83345997,True
792,93,2006-08-09,world trade center,65000000,70278893,163295654,98295654,True
793,94,2000-07-07,the kid,65000000,69688384,69688384,4688384,True
794,95,2003-12-19,mona lisa smile,65000000,63803100,141205169,76205169,False
795,96,2012-05-16,the dictator,65000000,59650222,180148897,115148897,False
796,97,1999-07-16,eyes wide shut,65000000,55691208,104267443,39267443,False
797,98,2012-02-17,this means war,65000000,54760791,156974557,91974557,False
798,99,2015-02-27,focus,65000000,53862963,168065700,103065700,False
799,100,2004-12-08,blade: trinity,65000000,52397389,131353165,66353165,False
800,1,2012-11-21,red dawn,65000000,44806783,48164150,-16835850,False
801,2,2006-12-22,we are marshall,65000000,43545364,43545364,-21454636,False
802,3,2015-09-18,everest,65000000,43482270,221297061,156297061,False
803,4,2012-09-14,resident evil: retribution,65000000,42345531,240647629,175647629,False
804,5,1998-03-20,primary colors,65000000,39017984,39017984,-25982016,False
805,6,1999-10-15,fight club,65000000,37030102,100851705,35851705,False
806,7,2008-08-22,death race,65000000,36316032,72516819,7516819,False
807,8,1996-10-11,the long kiss goodnight,65000000,33447612,33447612,-31552388,False
808,9,2000-12-08,proof of life,65000000,32598931,62761005,-2238995,False
809,10,2005-11-11,zathura,65000000,28045540,58545540,-6454460,False
810,11,2003-11-26,the missing,65000000,26900336,38253433,-26746567,False
811,12,2005-01-14,elektra,65000000,24409722,56824633,-8175367,False
812,13,2009-10-23,astro boy,65000000,19551067,41636243,-23363757,False
813,14,2014-01-24,"i, frankenstein",65000000,19075290,74575290,9575290,False
814,15,1991-05-24,hudson hawk,65000000,17218916,17218916,-47781084,False
815,16,2014-08-22,sin city: a dame to kill for,65000000,13757804,40650842,-24349158,False
816,17,2016-12-25,live by night,65000000,10378555,21774432,-43225568,False
817,18,2000-10-27,lucky numbers,65000000,10014234,10014234,-54985766,False
818,19,2005-09-23,oliver twist,65000000,2070920,26670920,-38329080,False
819,20,2015-09-04,tian jiang xiong shi,65000000,74070,122519874,57519874,False
820,21,2018-10-26,air strike,65000000,0,516279,-64483721,False
821,22,2006-07-14,little man,64000000,58636047,101636047,37636047,False
822,23,1999-10-08,random hearts,64000000,31054924,63200000,-800000,False
823,24,2006-12-27,perfume: the story of a murderer,63700000,2223293,133603463,69903463,False
824,25,1993-06-11,jurassic park,63000000,395708305,1038812584,975812584,True
825,26,2002-07-25,austin powers in goldmember,63000000,213117789,296338663,233338663,True
826,27,2011-04-01,hop,63000000,108085305,188657593,125657593,True
827,28,2017-09-15,american assassin,63000000,36249674,68310140,5310140,False
828,29,1994-06-24,wyatt earp,63000000,25052000,25052000,-37948000,False
829,30,1994-08-03,clear and present danger,62000000,122012656,207500000,145500000,True
830,31,2000-04-21,u-571,62000000,77086030,127630030,65630030,True
831,32,1995-11-17,the american president,62000000,60022813,107822813,45822813,False
832,33,2015-12-25,the hateful eight,62000000,54117416,147864886,85864886,False
833,34,2008-06-20,the love guru,62000000,32235793,40159017,-21840983,False
834,35,2001-02-23,3000 miles to graceland,62000000,15738632,18708848,-43291152,False
835,36,2014-10-03,gone girl,61000000,167767189,368567189,307567189,True
836,37,2007-03-30,blades of glory,61000000,118594548,145594548,84594548,True
837,38,2015-09-18,maze runner: the scorch trials,61000000,81697192,310566162,249566162,True
838,39,2013-08-02,2 guns,61000000,75612460,132493015,71493015,True
839,40,2018-01-26,maze runner: the death cure,61000000,58032443,265878536,204878536,False
840,41,2019-01-11,a dogâs way home,61000000,41952715,81149689,20149689,False
841,42,2016-02-19,mei ren yu,60720000,3229457,554516671,493796671,False
842,43,2004-12-22,meet the fockers,60000000,279167575,516567575,456567575,True
843,44,2014-02-07,the lego movie,60000000,257784718,457729388,397729388,True
844,45,2007-03-09,300,60000000,210614939,454161935,394161935,True
845,46,2007-03-02,wild hogs,60000000,168213584,253555383,193555383,True
846,47,2008-12-25,marley & me,60000000,143153751,247812011,187812011,True
847,48,1999-12-10,the green mile,60000000,136801374,290701374,230701374,True
848,49,1998-06-05,the truman show,60000000,125618201,264118201,204118201,True
849,50,2016-09-09,sully,60000000,125070033,238524556,178524556,True
850,51,2002-06-14,the bourne identity,60000000,121468960,214357371,154357371,True
851,52,2009-10-09,couples retreat,60000000,109205660,172450423,112450423,True
852,53,1995-11-17,goldeneye,60000000,106429941,356429941,296429941,True
853,54,2003-05-30,the italian job,60000000,106126012,176262839,116262839,True
854,55,2003-05-09,daddy day care,60000000,104148781,164285587,104285587,True
855,56,1999-06-18,the general's daughter,60000000,102705852,149705852,89705852,True
856,57,1998-12-18,the prince of egypt,60000000,101413188,218613188,158613188,True
857,58,2004-08-06,collateral,60000000,100170152,217670152,157670152,True
858,59,2001-07-04,cats & dogs,60000000,93375151,200700000,140700000,True
859,60,2002-12-20,two weeks notice,60000000,93354918,199043309,139043309,True
860,61,1998-10-02,antz,60000000,90757863,152457863,92457863,True
861,62,2002-04-19,the scorpion king,60000000,90580000,165890634,105890634,True
862,63,2010-10-15,red,60000000,90380162,196439693,136439693,True
863,64,2004-03-05,starsky & hutch,60000000,88200225,170200225,110200225,True
864,65,1990-06-27,days of thunder,60000000,82670733,157670733,97670733,True
865,66,2005-12-21,cheaper by the dozen 2,60000000,82571173,135015330,75015330,True
866,67,2010-08-13,eat pray love,60000000,80574010,206598789,146598789,True
867,68,2012-12-21,jack reacher,60000000,80070736,217370736,157370736,True
868,69,2004-04-23,man on fire,60000000,77906816,130968579,70968579,True
869,70,2000-12-22,the family man,60000000,75764085,124715863,64715863,True
870,71,2011-09-09,contagion,60000000,75658097,137551594,77551594,True
871,72,1999-12-22,any given sunday,60000000,75530832,100230832,40230832,True
872,73,1998-05-15,the horse whisperer,60000000,75383563,186883563,126883563,True
873,74,2009-02-06,coraline,60000000,75286229,126037057,66037057,True
874,75,2004-10-01,ladder 49,60000000,74541707,102332848,42332848,True
875,76,1999-07-28,deep blue sea,60000000,73648228,165048228,105048228,True
876,77,2009-10-28,michael jackson's this is it,60000000,72091016,252091016,192091016,True
877,78,2003-01-17,kangaroo jack,60000000,66723216,90723216,30723216,True
878,79,2008-06-13,the happening,60000000,64506874,162778384,102778384,True
879,80,2016-03-04,london has fallen,60000000,62524260,195194085,135194085,True
880,81,2000-04-07,rules of engagement,60000000,61322858,71719931,11719931,True
881,82,2006-03-10,the shaggy dog,60000000,61123569,87123569,27123569,True
882,83,1996-11-22,jingle all the way,60000000,60592389,129832389,69832389,True
883,84,2004-04-02,hellboy,60000000,59623958,99823958,39823958,False
884,85,2016-10-21,jack reacher: never go back,60000000,58697076,159946489,99946489,False
885,86,2017-05-25,baywatch,60000000,58060186,175863783,115863783,False
886,87,1998-12-25,a civil action,60000000,56709981,56709981,-3290019,False
887,88,2015-12-25,joy,60000000,56451232,101134059,41134059,False
888,89,2012-08-17,paranorman,60000000,56003051,108119662,48119662,False
889,90,1997-11-14,the jackal,60000000,54956941,159356941,99356941,False
890,91,2003-12-25,paycheck,60000000,53789313,98819789,38819789,False
891,92,1996-03-01,up close & personal,60000000,51045801,100645801,40645801,False
892,93,2008-12-19,the tale of despereaux,60000000,50877145,90482317,30482317,False
893,94,2014-09-26,the boxtrolls,60000000,50837305,111946251,51946251,False
894,95,2017-08-04,the dark tower,60000000,50701325,113461527,53461527,False
895,96,2002-09-27,the tuxedo,60000000,50586000,104429625,44429625,False
896,97,2014-01-17,jack ryan: shadow recruit,60000000,50577412,131377412,71377412,False
897,98,1995-07-14,under siege 2: dark territory,60000000,50024083,104324083,44324083,False
898,99,2005-03-24,miss congeniality 2: armed and fabulous,60000000,48478006,101382396,41382396,False
899,100,2018-12-25,vice,60000000,47836282,70883171,10883171,False
900,1,1997-11-26,alien: resurrection,60000000,47795018,160700000,100700000,False
901,2,2007-03-23,shooter,60000000,47003582,95538560,35538560,False
902,3,1998-10-16,practical magic,60000000,46850558,68336997,8336997,False
903,4,2013-01-11,gangster squad,60000000,46000903,104100903,44100903,False
904,5,2017-04-07,smurfs: the lost village,60000000,45020282,197578586,137578586,False
905,6,2018-10-12,first man,60000000,44936545,105203825,45203825,False
906,7,2009-06-19,year one,60000000,43337279,57604723,-2395277,False
907,8,2010-01-29,edge of darkness,60000000,43313890,82812456,22812456,False
908,9,2002-12-13,star trek: nemesis,60000000,43254409,67312826,7312826,False
909,10,2002-02-19,reign of fire,60000000,43061982,82150183,22150183,False
910,11,2009-11-20,planet 51,60000000,42194060,108996113,48996113,False
911,12,2009-03-20,duplicity,60000000,40572825,81079566,21079566,False
912,13,2008-09-12,righteous kill,60000000,40081410,78481410,18481410,False
913,14,2009-12-11,invictus,60000000,37491364,124514011,64514011,False
914,15,2009-04-17,state of play,60000000,37017955,88832210,28832210,False
915,16,1999-02-12,my favorite martian,60000000,36850101,36850101,-23149899,False
916,17,2006-04-21,the sentinel,60000000,36280697,78080697,18080697,False
917,18,2012-09-21,trouble with the curve,60000000,35763137,47818913,-12181087,False
918,19,2003-10-10,intolerable cruelty,60000000,35327628,121327628,61327628,False
919,20,1997-01-10,the relic,60000000,33956608,33956608,-26043392,False
920,21,1998-04-03,mercury rising,60000000,32983332,32983332,-27016668,False
921,22,2000-09-15,almost famous,60000000,32522352,47371191,-12628809,False
922,23,2019-02-08,cold pursuit,60000000,32138862,62599159,2599159,False
923,24,2002-12-06,analyze that,60000000,32122249,54994757,-5005243,False
924,25,2009-04-24,the soloist,60000000,31853584,38522450,-21477550,False
925,26,2013-08-21,the mortal instruments: city of bones,60000000,31165421,75965567,15965567,False
926,27,2000-11-03,the legend of bagger vance,60000000,30695227,39235486,-20764514,False
927,28,2002-02-22,dragonfly,60000000,30063805,30063805,-29936195,False
928,29,2011-05-13,priest,60000000,29136626,84154026,24154026,False
929,30,2006-06-16,garfield: a tail of two kitties,60000000,28426747,147985373,87985373,False
930,31,2005-04-29,xxx: state of the union,60000000,26873932,71073932,11073932,False
931,32,1997-08-15,event horizon,60000000,26673242,26673242,-33326758,False
932,33,2003-07-02,sinbad: legend of the seven seas,60000000,26483452,80767884,20767884,False
933,34,2005-07-08,dark water,60000000,25473093,49473093,-10526907,False
934,35,1998-08-14,the avengers,60000000,23385416,48585416,-11414584,False
935,36,2006-09-15,the black dahlia,60000000,22672813,49238525,-10761475,False
936,37,1999-03-26,edtv,60000000,22508689,35319689,-24680311,False
937,38,2008-12-25,the spirit,60000000,19806188,39006188,-20993812,False
938,39,2001-10-19,the last castle,60000000,18208078,20541668,-39458332,False
939,40,2009-01-23,inkheart,60000000,17303424,66655938,6655938,False
940,41,2000-01-14,supernova,60000000,14218868,14816494,-45183506,False
941,42,2006-09-22,flyboys,60000000,13090630,14816379,-45183621,False
942,43,2014-02-14,winterâs tale,60000000,12600231,29575033,-30424967,False
943,44,1998-10-09,holy man,60000000,12069719,12069719,-47930281,False
944,45,2008-07-11,meet dave,60000000,11803254,50648806,-9351194,False
945,46,2005-08-12,the great raid,60000000,10166502,10597070,-49402930,False
946,47,2017-02-24,rock dog,60000000,9420546,24148488,-35851512,False
947,48,2015-01-23,mortdecai,60000000,7696134,30396134,-29603866,False
948,49,2008-01-11,in the name of the king: a dungeon siege tale,60000000,4775656,13233220,-46766780,False
949,50,2003-10-24,beyond borders,60000000,4426297,11427090,-48572910,False
950,51,2016-02-05,xi you ji zhi sun wu kong san da bai gu jing,60000000,709982,194058503,134058503,False
951,52,2015-12-11,the ridiculous 6,60000000,0,0,-60000000,False
952,53,2019-11-08,midway,59500000,0,0,-59500000,False
953,54,2018-03-23,sherlock gnomes,59000000,43242871,87527651,28527651,False
954,55,2019-01-25,the kid who would be king,59000000,16790790,28348446,-30651554,False
955,56,2016-02-12,deadpool,58000000,363070709,801025593,743025593,True
956,57,2014-12-25,american sniper,58000000,350126372,547326372,489326372,True
957,58,2015-10-16,goosebumps,58000000,80069458,158905324,100905324,True
958,59,1988-05-25,rambo iii,58000000,53715611,188715611,130715611,False
959,60,1995-12-15,sabrina,58000000,53458319,87100000,29100000,False
960,61,2012-01-20,red tails,58000000,49876377,50365498,-7634502,False
961,62,2005-09-16,just like heaven,58000000,48318130,100687083,42687083,False
962,63,2013-06-07,the internship,58000000,44672764,93672764,35672764,False
963,64,2000-04-28,the flintstones in viva rock vegas,58000000,35231365,59431365,1431365,False
964,65,2008-04-04,leatherheads,58000000,31373938,41348628,-16651372,False
965,66,2017-03-24,life,58000000,30234022,100929666,42929666,False
966,67,2009-12-18,did you hear about the morgans?,58000000,29580087,80480566,22480566,False
967,68,2008-12-12,"che, part 1: the argentine",58000000,1802521,31627370,-26372630,False
968,69,2008-05-30,sex and the city,57500000,152647258,415247258,357747258,True
969,70,2010-09-10,resident evil: afterlife,57500000,60128566,295874190,238374190,True
970,71,2012-06-15,that's my boy,57500000,36931089,58085235,585235,False
971,72,1997-10-17,devil's advocate,57000000,61007424,153007424,96007424,True
972,73,2012-02-17,ghost rider: spirit of vengeance,57000000,51774002,149217355,92217355,False
973,74,1996-05-31,dragonheart,57000000,51364680,104364680,47364680,False
974,75,2004-11-12,after the sunset,57000000,28328132,38329114,-18670886,False
975,76,2001-08-17,captain corelli's mandolin,57000000,25528495,62097495,5097495,False
976,77,2014-12-25,into the woods,56200000,128002372,213116401,156916401,True
977,78,2003-04-11,anger management,56000000,135560942,195660942,139660942,True
978,79,2005-03-04,the pacifier,56000000,113006880,198006880,142006880,True
979,80,2004-04-02,walking tall,56000000,46213824,47313824,-8686176,False
980,81,2016-01-22,zhuo yao ji,56000000,32766,359495591,303495591,False
981,82,1994-07-06,forrest gump,55000000,330151138,679850637,624850637,True
982,83,2007-12-14,alvin and the chipmunks,55000000,217326974,362605033,307605033,True
983,84,2018-11-02,bohemian rhapsody,55000000,216303339,894985342,839985342,True
984,85,2005-02-11,hitch,55000000,177784257,366784257,311784257,True
985,86,2000-10-06,meet the parents,55000000,166225040,330425040,275425040,True
986,87,2006-12-15,the pursuit of happyness,55000000,162586036,307311093,252311093,True
987,88,1995-06-10,pocahontas,55000000,141579773,347100000,292100000,True
988,89,1978-12-15,superman,55000000,134218018,300200000,245200000,True
989,90,1996-06-28,the nutty professor,55000000,128814019,273814019,218814019,True
990,91,2017-02-10,fifty shades darker,55000000,114434010,381398492,326398492,True
991,92,2013-10-11,captain phillips,55000000,107136417,220648184,165648184,True
992,93,1997-07-16,george of the jungle,55000000,105263257,174463257,119463257,True
993,94,2003-08-01,american wedding,55000000,104354205,126425115,71425115,True
994,95,2017-11-10,murder on the orient express,55000000,102826543,345922730,290922730,True
995,96,2014-09-26,the equalizer,55000000,101530738,192903624,137903624,True
996,97,2018-02-09,fifty shades freed,55000000,100407760,371350619,316350619,True
997,98,1995-05-26,casper,55000000,100328194,282300000,227300000,True
998,99,2010-04-09,date night,55000000,98711404,152269033,97269033,True
999,100,2002-12-13,maid in manhattan,55000000,93932896,163838217,108838217,True
1000,1,1995-05-12,crimson tide,55000000,91387195,159387195,104387195,True
1001,2,2005-09-23,flightplan,55000000,89706988,214392904,159392904,True
1002,3,1994-12-09,disclosure,55000000,83015089,212200000,157200000,True
1003,4,1998-04-10,city of angels,55000000,78750909,198750909,143750909,True
1004,5,2015-01-16,paddington,55000000,76223578,258789097,203789097,True
1005,6,2006-04-28,r.v.,55000000,71724497,87473024,32473024,True
1006,7,1994-10-28,stargate,55000000,71565669,196565669,141565669,True
1007,8,2003-10-10,kill bill: volume 1,55000000,70098138,176469428,121469428,True
1008,9,2011-06-17,mr. poppers's penguins,55000000,68224452,189624452,134624452,True
1009,10,1999-08-13,bowfinger,55000000,66458769,98699769,43699769,True
1010,11,2004-04-16,kill bill: volume 2,55000000,66207920,153535982,98535982,True
1011,12,1989-12-22,tango & cash,55000000,63408614,63408614,8408614,True
1012,13,1992-07-31,death becomes her,55000000,58422650,149022650,94022650,True
1013,14,2000-05-26,shanghai noon,55000000,56932305,71189835,16189835,True
1014,15,1996-03-15,executive decision,55000000,56679192,122079192,67079192,True
1015,16,2013-11-01,free birds,55000000,55750480,110387072,55387072,True
1016,17,1992-05-22,alien 3,55000000,54927174,158500000,103500000,False
1017,18,2008-04-18,the forbidden kingdom,55000000,52075270,129075270,74075270,False
1018,19,2004-12-22,the phantom of the opera,55000000,51225796,153770052,98770052,False
1019,20,2014-03-21,muppets most wanted,55000000,51178893,79312301,24312301,False
1020,21,1996-12-25,evita,55000000,50047179,151947179,96947179,False
1021,22,2016-08-19,kubo and the two strings,55000000,48023088,77548122,22548122,False
1022,23,1998-09-25,ronin,55000000,41610884,70692101,15692101,False
1023,24,2010-11-24,burlesque,55000000,39440655,90552675,35552675,False
1024,25,1996-10-11,the ghost and the darkness,55000000,38564422,38564422,-16435578,False
1025,26,2008-10-24,changeling,55000000,35739802,113805580,58805580,False
1026,27,2012-07-27,the watch,55000000,34353000,67130045,12130045,False
1027,28,2003-03-14,the hunted,55000000,34234008,47213095,-7786905,False
1028,29,1999-06-04,instinct,55000000,34105207,34105207,-20894793,False
1029,30,2003-12-12,stuck on you,55000000,33832741,63537164,8537164,False
1030,31,2008-02-29,semi-pro,55000000,33479698,43980363,-11019637,False
1031,32,2018-02-23,annihilation,55000000,32732301,43070915,-11929085,False
1032,33,2015-10-16,crimson peak,55000000,31090320,74966854,19966854,False
1033,34,2012-04-27,the pirates! band of misfits,55000000,31051126,136143605,81143605,False
1034,35,2005-12-02,aeon flux,55000000,25857987,53913573,-1086427,False
1035,36,1996-08-02,chain reaction,55000000,21226204,60209334,5209334,False
1036,37,1996-08-16,the fan,55000000,18582965,18582965,-36417035,False
1037,38,2007-10-12,elizabeth: the golden age,55000000,16285240,74870866,19870866,False
1038,39,2009-06-12,imagine that,55000000,16222392,22438144,-32561856,False
1039,40,2003-02-21,gods and generals,55000000,12882934,12923936,-42076064,False
1040,41,1997-01-10,turbulence,55000000,11532774,11532774,-43467226,False
1041,42,2013-02-01,bullet to the head,55000000,9489829,22597969,-32402031,False
1042,43,2006-09-22,all the king's men,55000000,7221458,9521458,-45478542,False
1043,44,2004-07-30,thunderbirds,55000000,6768055,28231444,-26768556,False
1044,45,2004-11-26,un long dimanche de fianã§ailles,55000000,6167817,69759296,14759296,False
1045,46,2007-05-04,lucky you,55000000,5755286,6521829,-48478171,False
1046,47,1998-07-22,lolita,55000000,1147784,1147784,-53852216,False
1047,48,2002-09-20,eye see you,55000000,79161,1807990,-53192010,False
1048,49,1981-06-19,superman ii,54000000,108185706,108185706,54185706,True
1049,50,2002-03-22,blade 2,54000000,81676888,154338601,100338601,True
1050,51,2006-07-14,"you, me and dupree",54000000,75802010,130402010,76402010,True
1051,52,2008-12-19,seven pounds,54000000,69951824,166617328,112617328,True
1052,53,1990-12-25,the godfather: part iii,54000000,66520529,66520529,12520529,True
1053,54,2005-10-14,elizabethtown,54000000,26850426,50719373,-3280627,False
1054,55,2003-08-01,gigli,54000000,6087542,7126002,-46873998,False
1055,56,2000-06-16,shaft,53012938,70327868,107190108,54177170,True
1056,57,2005-08-05,the dukes of hazzard,53000000,80270227,109848461,56848461,True
1057,58,2009-10-16,law abiding citizen,53000000,73357727,131159781,78159781,True
1058,59,2015-09-18,black mass,53000000,62575678,98837872,45837872,True
1059,60,1997-11-14,anastasia,53000000,58403409,139801096,86801096,True
1060,61,2001-05-18,moulin rouge,53000000,57386369,179200588,126200588,True
1061,62,2001-11-02,domestic disturbance,53000000,45207112,54207112,1207112,False
1062,63,2006-10-20,flags of our fathers,53000000,33602376,63657941,10657941,False
1063,64,2007-04-06,grindhouse,53000000,25031037,50187789,-2812211,False
1064,65,1998-10-16,beloved,53000000,22852487,22852487,-30147513,False
1065,66,2012-12-19,zero dark thirty,52500000,95720716,134612435,82112435,True
1066,67,2002-12-25,catch me if you can,52000000,164606800,355612291,303612291,True
1067,68,2008-07-18,mamma mia!,52000000,144130063,615748772,563748772,True
1068,69,2006-06-02,the break-up,52000000,118703275,205727307,153727307,True
1069,70,2010-02-12,valentine's day,52000000,110485654,217569328,165569328,True
1070,71,1995-11-22,casino,52000000,42438300,110400000,58400000,False
1071,72,2011-08-05,the change-up,52000000,37243418,75997067,23997067,False
1072,73,1998-12-23,the thin red line,52000000,36400491,97709034,45709034,False
1073,74,1999-12-22,man on the moon,52000000,34580635,47407635,-4592365,False
1074,75,2010-02-05,from paris with love,52000000,24077427,53139168,1139168,False
1075,76,2003-04-16,bulletproof monk,52000000,23010607,23010607,-28989393,False
1076,77,2000-06-23,"me, myself & irene",51000000,90570999,149270999,98270999,True
1077,78,2006-08-04,barnyard: the original party animals,51000000,72779000,118583844,67583844,True
1078,79,2018-08-17,alpha,51000000,35851379,99624873,48624873,False
1079,80,2006-11-22,deck the halls,51000000,35093569,46815807,-4184193,False
1080,81,2011-03-04,the adjustment bureau,50200000,62495645,126931325,76731325,True
1081,82,2009-11-20,the twilight saga: new moon,50000000,296623634,687557727,637557727,True
1082,83,2001-05-18,shrek,50000000,267655011,491812794,441812794,True
1083,84,2012-06-29,ted,50000000,218665740,556016627,506016627,True
1084,85,2014-06-13,22 jump street,50000000,191719337,331333876,281333876,True
1085,86,1991-06-14,robin hood: prince of thieves,50000000,165493908,390500000,340500000,True
1086,87,1996-12-13,jerry maguire,50000000,153952592,274000000,224000000,True
1087,88,2015-12-25,daddyâs home,50000000,150357137,242757137,192757137,True
1088,89,1997-12-24,as good as it gets,50000000,148478011,314111923,264111923,True
1089,90,1998-12-25,patch adams,50000000,135014968,202173000,152173000,True
1090,91,2016-06-17,central intelligence,50000000,127440871,217194805,167194805,True
1091,92,2013-12-18,anchorman 2: the legend continues,50000000,127352707,172185754,122185754,True
1092,93,2011-06-10,super 8,50000000,127004179,257972745,207972745,True
1093,94,2002-06-28,mr. deeds,50000000,126293452,171269535,121269535,True
1094,95,2000-03-17,erin brockovich,50000000,125548685,257805243,207805243,True
1095,96,2018-11-21,creed ii,50000000,115715889,213591522,163591522,True
1096,97,2018-02-09,peter rabbit,50000000,115234093,347136477,297136477,True
1097,98,2003-02-07,how to lose a guy in 10 days,50000000,105807520,178890782,128890782,True
1098,99,1994-11-11,interview with the vampire: the vampire chronicles,50000000,105264608,223564608,173564608,True
1099,100,2018-12-14,the mule,50000000,103804407,170857676,120857676,True
1100,1,2008-12-19,yes man,50000000,97690976,225990976,175990976,True
1101,2,2014-02-28,non-stop,50000000,91742160,222383055,172383055,True
1102,3,1998-12-25,stepmom,50000000,91137662,159745279,109745279,True
1103,4,2013-08-09,disney planes,50000000,90282580,238059569,188059569,True
1104,5,2006-03-10,failure to launch,50000000,88715192,128402901,78402901,True
1105,6,2006-03-24,inside man,50000000,88634237,185798265,135798265,True
1106,7,2017-07-28,the emoji movie,50000000,86089513,216562312,166562312,True
1107,8,2011-07-29,"crazy, stupid, love",50000000,84351197,147142328,97142328,True
1108,9,2017-12-22,the post,50000000,81903458,179748880,129748880,True
1109,10,1999-02-05,payback,50000000,81526121,161626121,111626121,True
1110,11,1995-06-09,congo,50000000,81022333,152022333,102022333,True
1111,12,2009-03-20,knowing,50000000,79957634,186450317,136450317,True
1112,13,2005-03-18,the ring two,50000000,75941727,161941727,111941727,True
1113,14,2011-12-23,we bought a zoo,50000000,75624550,118729073,68729073,True
1114,15,2011-09-23,moneyball,50000000,75605492,111300835,61300835,True
1115,16,2004-06-11,garfield: the movie,50000000,75367693,208094550,158094550,True
1116,17,2004-11-24,christmas with the kranks,50000000,73701902,96469187,46469187,True
1117,18,2006-03-17,v for vendetta,50000000,70511035,130214162,80214162,True
1118,19,1995-03-10,outbreak,50000000,67823573,190023573,140023573,True
1119,20,2009-03-13,race to witch mountain,50000000,67172595,105103784,55103784,True
1120,21,2004-09-24,the forgotten,50000000,66711892,117211892,67211892,True
1121,22,2005-06-22,herbie: fully loaded,50000000,66010682,144110682,94110682,True
1122,23,2003-02-07,shanghai knights,50000000,60470220,88316835,38316835,True
1123,24,2014-07-18,planes: fire and rescue,50000000,59157732,156399644,106399644,True
1124,25,2006-02-10,curious george,50000000,58640119,71052604,21052604,True
1125,26,2012-04-06,american reunion,50000000,56758835,236799211,186799211,True
1126,27,2013-01-25,hansel & gretel: witch hunters,50000000,55703475,214949716,164949716,True
1127,28,2011-02-18,i am number four,50000000,55100437,146195159,96195159,True
1128,29,2001-09-28,donât say a word,50000000,54997476,104488383,54488383,True
1129,30,2016-01-15,13 hours: the secret soldiers of benghazi,50000000,52853219,69411370,19411370,True
1130,31,2002-05-08,unfaithful,50000000,52752475,119114494,69114494,True
1131,32,2017-09-29,american made,50000000,51342000,135569212,85569212,True
1132,33,2005-11-23,syriana,50000000,50824620,92690959,42690959,True
1133,34,2004-09-10,resident evil: apocalypse,50000000,50740078,125168734,75168734,True
1134,35,2014-10-17,the book of life,50000000,50151543,97651543,47651543,True
1135,36,1997-02-14,absolute power,50000000,50068310,50068310,68310,True
1136,37,2006-02-10,firewall,50000000,48751189,82751189,32751189,False
1137,38,1997-09-12,the game,50000000,48265581,80369970,30369970,False
1138,39,1997-08-22,g.i. jane,50000000,48169156,48169156,-1830844,False
1139,40,2014-08-08,into the storm,50000000,47602194,150429371,100429371,False
1140,41,2014-10-10,the judge,50000000,47119388,76119388,26119388,False
1141,42,2006-04-21,silent hill,50000000,46982632,94704227,44704227,False
1142,43,2000-08-11,the replacements,50000000,44737059,50054511,54511,False
1143,44,1998-07-29,the negotiator,50000000,44705766,49105766,-894234,False
1144,45,2016-08-19,war dogs,50000000,43034523,86234503,36234503,False
1145,46,1994-05-25,beverly hills cop iii,50000000,42586861,119180938,69180938,False
1146,47,1990-06-15,gremlins 2: the new batch,50000000,41476097,41476097,-8523903,False
1147,48,1997-09-26,the peacemaker,50000000,41263140,62967368,12967368,False
1148,49,2003-10-03,out of time,50000000,41083108,55489826,5489826,False
1149,50,2004-11-12,bridget jones: the edge of reason,50000000,40203020,263894551,213894551,False
1150,51,2000-02-11,the beach,50000000,39778599,39778599,-10221401,False
1151,52,2005-06-10,the adventures of sharkboy and lavagirl in 3-d,50000000,39177684,69425966,19425966,False
1152,53,1994-02-18,on deadly ground,50000000,38590458,38590458,-11409542,False
1153,54,2009-11-25,ninja assassin,50000000,38122883,62209892,12209892,False
1154,55,2004-05-28,raising helen,50000000,37485528,49928680,-71320,False
1155,56,2016-05-20,the nice guys,50000000,36261763,59596747,9596747,False
1156,57,1999-09-17,for love of the game,50000000,35188640,46112640,-3887360,False
1157,58,1998-12-11,jack frost,50000000,34645374,34645374,-15354626,False
1158,59,2010-06-04,marmaduke,50000000,33644788,89895930,39895930,False
1159,60,1996-06-28,striptease,50000000,33109743,113309743,63309743,False
1160,61,2010-10-15,hereafter,50000000,32746941,108660270,58660270,False
1161,62,2002-04-19,murder by numbers,50000000,31874869,56643267,6643267,False
1162,63,1995-10-06,assassins,50000000,30306268,83306268,33306268,False
1163,64,2016-02-12,zoolander 2,50000000,28848693,55348693,5348693,False
1164,65,2009-01-16,defiance,50000000,28644813,52987754,2987754,False
1165,66,2007-02-09,hannibal rising,50000000,27669725,80583311,30583311,False
1166,67,1999-10-15,the story of us,50000000,27100030,27100030,-22899970,False
1167,68,2013-03-29,the host,50000000,26623701,64477051,14477051,False
1168,69,2003-03-28,basic,50000000,26599248,42598498,-7401502,False
1169,70,2015-03-13,run all night,50000000,26461644,66961644,16961644,False
1170,71,2002-08-09,blood work,50000000,26199517,26199517,-23800483,False
1171,72,2009-02-13,the international,50000000,25450527,53850527,3850527,False
1172,73,1996-08-09,escape from l.a.,50000000,25426861,25426861,-24573139,False
1173,74,2004-02-27,twisted,50000000,25195050,40119848,-9880152,False
1174,75,2004-12-10,the life aquatic with steve zissou,50000000,24006726,34806726,-15193274,False
1175,76,1999-08-04,the iron giant,50000000,23159305,31333917,-18666083,False
1176,77,2019-04-12,hellboy,50000000,21903748,40725492,-9274508,False
1177,78,2011-04-08,your highness,50000000,21596445,26121638,-23878362,False
1178,79,2016-09-16,snowden,50000000,21587519,35380918,-14619082,False
1179,80,2011-09-30,dream house,50000000,21302340,41642166,-8357834,False
1180,81,2016-06-24,free state of jones,50000000,20810036,23237252,-26762748,False
1181,82,2009-09-04,gamer,50000000,20534907,42002029,-7997971,False
1182,83,2005-02-25,man of the house,50000000,19699706,22099706,-27900294,False
1183,84,2003-02-21,the life of david gale,50000000,19694635,28920188,-21079812,False
1184,85,2013-02-14,beautiful creatures,50000000,19452138,60282876,10282876,False
1185,86,2005-09-30,into the blue,50000000,18782227,41982227,-8017773,False
1186,87,2007-09-14,eastern promises,50000000,17181265,56077088,6077088,False
1187,88,1994-07-01,baby's day out,50000000,16581575,16581575,-33418425,False
1188,89,1999-11-12,the messenger: the story of joan of arc,50000000,14271297,14271297,-35728703,False
1189,90,1995-11-03,fair game,50000000,11497497,26097497,-23902503,False
1190,91,2011-02-25,drive angry,50000000,10721033,41042583,-8957417,False
1191,92,1997-11-07,mad city,50000000,10561038,10561038,-39438962,False
1192,93,1995-10-13,the scarlet letter,50000000,10359006,10359006,-39640994,False
1193,94,2005-10-14,domino,50000000,10169202,23574057,-26425943,False
1194,95,1995-10-13,jade,50000000,9812870,9812870,-40187130,False
1195,96,2009-02-27,street fighter: the legend of chun-li,50000000,8742261,12660287,-37339713,False
1196,97,2002-03-29,death to smoochy,50000000,8355815,8374062,-41625938,False
1197,98,2018-02-16,early man,50000000,8267544,45285890,-4714110,False
1198,99,2009-11-13,the boat that rocked,50000000,8017467,37472651,-12527349,False
1199,100,2004-01-30,the big bounce,50000000,6471394,6626115,-43373885,False
1200,1,2000-03-03,what planet are you from?,50000000,6291602,6291602,-43708398,False
1201,2,2015-04-17,child 44,50000000,1224330,8004221,-41995779,False
1202,3,2009-01-23,outlander,50000000,166003,1250617,-48749383,False
1203,4,2013-03-15,upside down,50000000,102118,26387039,-23612961,False
1204,5,2015-10-02,shanghai,50000000,46425,15505922,-34494078,False
1205,6,2020-12-31,hannibal the conqueror,50000000,0,0,-50000000,False
1206,7,2019-11-08,arctic dogs,50000000,0,0,-50000000,False
1207,8,2019-11-22,the rhythm section,50000000,0,0,-50000000,False
1208,9,2019-09-20,ad astra,49800000,0,0,-49800000,False
1209,10,2001-11-02,the one,49000000,43905746,72689126,23689126,False
1210,11,2015-03-06,chappie,49000000,31569268,105002056,56002056,False
1211,12,1990-07-11,the adventures of ford fairlane,49000000,20423389,20423389,-28576611,False
1212,13,2012-11-16,anna karenina,49000000,12816367,71004627,22004627,False
1213,14,1989-05-24,indiana jones and the last crusade,48000000,197171806,474171806,426171806,True
1214,15,2002-10-18,the ring,48000000,129094024,248218486,200218486,True
1215,16,2000-12-27,traffic,48000000,124107476,208300000,160300000,True
1216,17,2002-03-29,panic room,48000000,95308367,196308367,148308367,True
1217,18,2015-01-09,taken 3,48000000,89256424,327656424,279656424,True
1218,19,1999-08-06,the thomas crown affair,48000000,69304264,124304264,76304264,True
1219,20,2018-11-16,instant family,48000000,67363237,119736188,71736188,True
1220,21,1999-11-05,the bone collector,48000000,66488090,151463090,103463090,True
1221,22,1999-10-01,three kings,48000000,60652036,107752036,59752036,True
1222,23,2010-01-22,tooth fairy,48000000,60022256,112610386,64610386,True
1223,24,2001-08-17,rat race,48000000,56607223,86607223,38607223,True
1224,25,2007-09-07,3:10 to yuma,48000000,53606916,71171825,23171825,True
1225,26,2001-08-13,k-pax,48000000,50315140,50315140,2315140,True
1226,27,2001-12-25,kate and leopold,48000000,47095453,70937778,22937778,False
1227,28,2000-10-20,bedazzled,48000000,37879996,90376224,42376224,False
1228,29,1998-06-26,out of sight,48000000,37562568,77562568,29562568,False
1229,30,1984-12-14,the cotton club,48000000,25928721,25928721,-22071279,False
1230,31,2008-01-25,rambo,47500000,42754105,112214531,64714531,False
1231,32,2016-07-13,the infiltrator,47500000,15436808,20718104,-26781896,False
1232,33,1990-06-15,dick tracy,47000000,103738726,162738726,115738726,True
1233,34,2016-11-11,arrival,47000000,100546139,203127894,156127894,True
1234,35,1996-06-14,the cable guy,47000000,60240295,102825796,55825796,True
1235,36,2009-04-22,earth,47000000,32011576,116773317,69773317,False
1236,37,2001-10-19,riding in cars with boys,47000000,29781453,29781453,-17218547,False
1237,38,2007-01-05,happily n'ever after,47000000,15849032,37923818,-9076182,False
1238,39,2002-11-27,solaris,47000000,14970038,14970038,-32029962,False
1239,40,2010-06-18,jonah hex,47000000,10547117,11022696,-35977304,False
1240,41,1996-02-23,mary reilly,47000000,5707094,12900000,-34100000,False
1241,42,2016-12-23,silence,46500000,7100177,23726626,-22773374,False
1242,43,2013-11-01,mr. nobody,46500000,3622,22254,-46477746,False
1243,44,1997-06-20,my best friend's wedding,46000000,126813153,298923419,252923419,True
1244,45,2001-07-20,america's sweethearts,46000000,93607673,160648493,114648493,True
1245,46,1996-11-22,star trek: first contact,46000000,92027888,150000000,104000000,True
1246,47,2002-05-24,insomnia,46000000,67263182,113622499,67622499,True
1247,48,2013-09-20,prisoners,46000000,61002302,113402302,67402302,True
1248,49,1996-07-12,courage under fire,46000000,59003384,100833145,54833145,True
1249,50,1982-09-17,inchon,46000000,4408636,4408636,-41591364,False
1250,51,2010-12-31,arthur and the war of two worlds,45500000,347136,36180824,-9319176,False
1251,52,1997-03-21,liar liar,45000000,181410615,302710615,257710615,True
1252,53,1998-11-20,a bug's life,45000000,162798565,363095319,318095319,True
1253,54,2012-10-05,taken 2,45000000,139854287,377807404,332807404,True
1254,55,1994-05-27,the flintstones,45000000,130531208,358500000,313500000,True
1255,56,2003-10-24,scary movie 3,45000000,110000082,155200000,110200000,True
1256,57,2000-12-22,miss congeniality,45000000,106807667,213420951,168420951,True
1257,58,2017-12-22,pitch perfect 3,45000000,104897530,185736412,140736412,True
1258,59,2008-07-11,journey to the center of the earth,45000000,101704370,243180937,198180937,True
1259,60,1993-12-17,the pelican brief,45000000,100768056,187995859,142995859,True
1260,61,2004-08-11,the princess diaries 2: royal engagement,45000000,95149435,122071435,77071435,True
1261,62,2007-12-25,the bucket list,45000000,93466502,174807445,129807445,True
1262,63,1994-07-20,the client,45000000,92115211,117615211,72615211,True
1263,64,2011-11-23,the muppets,45000000,88625922,160971922,115971922,True
1264,65,1992-06-05,patriot games,45000000,83287363,178100000,133100000,True
1265,66,2005-05-13,monster-in-law,45000000,82931301,155931301,110931301,True
1266,67,2001-10-05,training day,45000000,76261036,104505362,59505362,True
1267,68,2016-10-07,the girl on the train,45000000,75395035,174278214,129278214,True
1268,69,1999-12-24,galaxy quest,45000000,71423726,90523726,45523726,True
1269,70,2001-07-04,scary movie 2,45000000,71277420,141189101,96189101,True
1270,71,1998-08-21,blade,45000000,70141876,131237688,86237688,True
1271,72,2005-01-14,coach carter,45000000,67264877,76665507,31665507,True
1272,73,2010-03-19,the bounty hunter,45000000,67061228,135808837,90808837,True
1273,74,2002-04-12,changing lanes,45000000,66790248,66790248,21790248,True
1274,75,1997-04-11,anaconda,45000000,65598907,136998907,91998907,True
1275,76,2006-01-20,underworld: evolution,45000000,62318875,113417762,68417762,True
1276,77,2000-08-04,coyote ugly,45000000,60786269,113916474,68916474,True
1277,78,2003-11-07,love actually,45000000,59472278,248505300,203505300,True
1278,79,1996-08-09,jack,45000000,58617334,58617334,13617334,True
1279,80,1994-10-07,the specialist,45000000,57362581,57362581,12362581,True
1280,81,2016-12-09,office christmas party,45000000,54767494,91323299,46323299,True
1281,82,1996-08-16,tin cup,45000000,53854588,75854588,30854588,True
1282,83,2005-11-23,"yours, mine and ours",45000000,53359917,72359917,27359917,True
1283,84,2005-05-13,kicking and screaming,45000000,52842724,55842724,10842724,True
1284,85,2005-04-29,the hitchhiker's guide to the galaxy,45000000,51019112,102746214,57746214,True
1285,86,2007-09-21,resident evil: extinction,45000000,50648679,149871103,104871103,True
1286,87,2004-12-25,fat albert,45000000,48114556,48563556,3563556,True
1287,88,2012-07-06,savages,45000000,47323100,82513490,37513490,True
1288,89,1994-09-30,the river wild,45000000,46815000,94215000,49215000,True
1289,90,2014-05-23,blended,45000000,46290741,127990741,82990741,True
1290,91,2017-06-16,all eyez on me,45000000,44922302,54876855,9876855,False
1291,92,2006-01-13,last holiday,45000000,38399961,43343247,-1656753,False
1292,93,2006-03-03,16 blocks,45000000,36895141,65595141,20595141,False
1293,94,1995-07-14,the indian in the cupboard,45000000,35627222,35627222,-9372778,False
1294,95,2004-09-10,cellular,45000000,32003620,61475984,16475984,False
1295,96,2006-07-28,the ant bully,45000000,28142535,49610898,4610898,False
1296,97,2003-07-18,johnny english,45000000,28013509,163126676,118126676,False
1297,98,1984-12-14,dune,45000000,27447471,27447471,-17552529,False
1298,99,2009-07-31,aliens in the attic,45000000,25200412,59551283,14551283,False
1299,100,2007-09-14,across the universe,45000000,24343673,29367143,-15632857,False
1300,1,2008-12-26,revolutionary road,45000000,22951340,79604820,34604820,False
1301,2,2008-08-29,babylon a.d.,45000000,22532572,70216497,25216497,False
1302,3,1994-11-04,frankenstein,45000000,22006296,112006296,67006296,False
1303,4,1996-10-04,the glimmer man,45000000,20404841,36404841,-8595159,False
1304,5,1996-07-17,multiplicity,45000000,20133326,20133326,-24866674,False
1305,6,2019-05-03,uglydolls,45000000,19894664,24644664,-20355336,False
1306,7,2001-01-19,the pledge,45000000,19719930,29406132,-15593868,False
1307,8,2005-12-16,the producers: the movie musical,45000000,19398532,32952995,-12047005,False
1308,9,1996-06-07,the phantom,45000000,17220599,17220599,-27779401,False
1309,10,2005-07-01,rebound,45000000,16809014,17492014,-27507986,False
1310,11,2010-02-19,the ghost writer,45000000,15541549,65532491,20532491,False
1311,12,2000-12-22,all the pretty horses,45000000,15527125,18120267,-26879733,False
1312,13,2008-09-05,bangkok dangerous,45000000,15298133,46598133,1598133,False
1313,14,1995-12-20,nixon,45000000,13668249,34668249,-10331751,False
1314,15,2012-09-21,dredd,45000000,13414714,41467606,-3532394,False
1315,16,2011-10-28,the rum diary,45000000,13109815,21544732,-23455268,False
1316,17,1998-01-30,deep rising,45000000,11203026,11203026,-33796974,False
1317,18,2018-12-21,welcome to marwen,45000000,10763520,12874922,-32125078,False
1318,19,2011-10-21,johnny english reborn,45000000,8406711,164640401,119640401,False
1319,20,2008-09-26,miracle at st. anna,45000000,7916887,9676497,-35323503,False
1320,21,2002-04-05,big trouble,45000000,7262288,8488871,-36511129,False
1321,22,2006-12-21,man cheng jin dai huang jin jia,45000000,6566773,76904429,31904429,False
1322,23,2007-11-16,love in the time of cholera,45000000,4617608,31077418,-13922582,False
1323,24,2002-12-25,pinocchio,45000000,3681811,31681811,-13318189,False
1324,25,1997-01-31,shadow conspiracy,45000000,2154540,2154540,-42845460,False
1325,26,2012-12-31,foodfight!,45000000,0,73706,-44926294,False
1326,27,2012-10-12,argo,44500000,136025503,227140757,182640757,True
1327,28,1993-08-06,the fugitive,44000000,183875760,353715317,309715317,True
1328,29,1985-05-22,rambo: first blood part ii,44000000,150415432,300400000,256400000,True
1329,30,1996-10-18,sleepers,44000000,53300852,165600852,121600852,True
1330,31,2010-07-30,charlie st. cloud,44000000,31206263,48478084,4478084,False
1331,32,1996-02-02,the juror,44000000,22730924,22730924,-21269076,False
1332,33,2014-02-06,the interview,44000000,6105175,12342632,-31657368,False
1333,34,1980-11-19,heaven's gate,44000000,3484331,3484523,-40515477,False
1334,35,2013-06-28,the heat,43000000,159581587,229727774,186727774,True
1335,36,2000-12-19,finding forrester,43000000,51768623,80013623,37013623,True
1336,37,2000-04-14,28 days,43000000,37035515,62063972,19063972,False
1337,38,2005-05-13,danny the dog,43000000,24537621,49037621,6037621,False
1338,39,2002-04-12,the sweetest thing,43000000,24430272,63078756,20078756,False
1339,40,2018-11-09,the girl in the spiderâs web,43000000,14828555,34983342,-8016658,False
1340,41,2017-01-06,a monster calls,43000000,3740823,46414530,3414530,False
1341,42,2011-01-28,the mechanic,42500000,29121498,76347393,33847393,False
1342,43,1993-06-30,the firm,42000000,158340892,270340892,228340892,True
1343,44,2012-03-16,21 jump street,42000000,138447667,202812429,160812429,True
1344,45,1999-05-28,notting hill,42000000,116089678,363728085,321728085,True
1345,46,2000-06-21,chicken run,42000000,106793915,227793915,185793915,True
1346,47,2004-01-16,along came polly,42000000,88073507,173044410,131044410,True
1347,48,1992-07-01,boomerang,42000000,70052444,131052444,89052444,True
1348,49,2009-07-10,brã¼no,42000000,60054530,138708527,96708527,True
1349,50,1963-06-12,cleopatra,42000000,57000000,71000000,29000000,True
1350,51,2017-05-12,snatched,42000000,45852178,57852177,15852177,True
1351,52,2012-10-12,here comes the boom,42000000,45290318,73239258,31239258,True
1352,53,2002-04-05,high crimes,42000000,41543207,63781100,21781100,False
1353,54,1996-11-15,the mirror has two faces,42000000,41267469,41267469,-732531,False
1354,55,2011-03-11,red riding hood,42000000,37662162,91678442,49678442,False
1355,56,2002-01-25,the mothman prophecies,42000000,35228696,56438555,14438555,False
1356,57,1989-07-14,licence to kill,42000000,34667015,156167015,114167015,False
1357,58,2018-12-25,holmes & watson,42000000,30568743,41926605,-73395,False
1358,59,2012-01-27,one for the money,42000000,26414527,36197221,-5802779,False
1359,60,2001-03-09,15 minutes,42000000,24375436,56331864,14331864,False
1360,61,2005-09-16,lord of war,42000000,24149632,60437727,18437727,False
1361,62,1993-05-28,super mario bros.,42000000,20844907,20844907,-21155093,False
1362,63,1992-10-02,hero,42000000,19487173,66787173,24787173,False
1363,64,2012-01-27,man on a ledge,42000000,18620000,49621440,7621440,False
1364,65,2010-12-03,the warrior's way,42000000,5666340,8514325,-33485675,False
1365,66,1997-04-18,mchale's navy,42000000,4408420,4408420,-37591580,False
1366,67,2010-05-28,micmacs,42000000,1259693,11756922,-30243078,False
1367,68,2006-12-31,les bronzã©s 3: amis pour la vie,42000000,0,83833602,41833602,False
1368,69,2015-12-31,pourquoi j'ai pas mangã© mon pã¨re,42000000,0,15451663,-26548337,False
1369,70,2002-11-08,8 mile,41000000,116724075,245768384,204768384,True
1370,71,2019-05-31,rocketman,41000000,57342725,108642725,67642725,True
1371,72,2001-05-11,a knightâs tale,41000000,56083966,100622586,59622586,True
1372,73,2003-08-22,the medallion,41000000,22108977,22108977,-18891023,False
1373,74,2011-10-14,the big year,41000000,7204138,7684524,-33315476,False
1374,75,1999-08-06,the sixth sense,40000000,293506292,672806292,632806292,True
1375,76,2005-07-15,wedding crashers,40000000,209218368,283218368,243218368,True
1376,77,2010-06-11,the karate kid,40000000,176591618,351774938,311774938,True
1377,78,2015-02-13,fifty shades of grey,40000000,166167230,570998101,530998101,True
1378,79,2009-06-19,the proposal,40000000,163958031,314709717,274709717,True
1379,80,2013-12-13,american hustle,40000000,150117807,257878294,217878294,True
1380,81,2019-05-17,john wick: chapter 3 â parabellum,40000000,141744320,256498033,216498033,True
1381,82,2003-12-25,cheaper by the dozen,40000000,138614544,190212113,150212113,True
1382,83,2014-07-25,lucy,40000000,126573960,457507776,417507776,True
1383,84,2013-12-25,lone survivor,40000000,125095601,149804632,109804632,True
1384,85,1989-11-22,back to the future part ii,40000000,118450002,332000000,292000000,True
1385,86,1999-09-24,double jeopardy,40000000,116735231,177835231,137835231,True
1386,87,2003-07-25,spy kids 3-d: game over,40000000,111760631,167851995,127851995,True
1387,88,1996-07-24,a time to kill,40000000,108766007,152266007,112266007,True
1388,89,1992-07-01,a league of their own,40000000,107533925,132440066,92440066,True
1389,90,2016-06-10,the conjuring 2: the enfield poltergeist,40000000,102470008,311262102,271262102,True
1390,91,2010-10-01,the social network,40000000,96962694,224922135,184922135,True
1391,92,2009-08-07,julie & julia,40000000,94125426,126646119,86646119,True
1392,93,2009-02-06,he's just not that into you,40000000,93953653,181053657,141053657,True
1393,94,2017-02-10,john wick: chapter two,40000000,92029184,171350009,131350009,True
1394,95,2016-01-15,ride along 2,40000000,90862685,124827316,84827316,True
1395,96,2006-04-14,scary movie 4,40000000,90710620,178710620,138710620,True
1396,97,2015-03-27,get hard,40000000,90411453,106511453,66511453,True
1397,98,2000-02-04,scream 3,40000000,89138076,161838076,121838076,True
1398,99,1990-05-24,back to the future part iii,40000000,88055283,244088654,204088654,True
1399,100,2016-10-14,the accountant,40000000,86260045,152962083,112962083,True
1400,1,2014-11-14,dumb and dumber to,40000000,86208010,156553592,116553592,True
1401,2,2014-04-25,the other woman,40000000,83911193,195111193,155111193,True
1402,3,1992-11-13,bram stoker's dracula,40000000,82522790,215862692,175862692,True
1403,4,2006-02-17,eight below,40000000,81612565,120455994,80455994,True
1404,5,1999-12-24,the talented mr. ripley,40000000,81292135,128792135,88792135,True
1405,6,2015-09-25,the intern,40000000,75764672,197115710,157115710,True
1406,7,1992-09-25,the last of the mohicans,40000000,75505856,75505856,35505856,True
1407,8,2004-10-29,ray,40000000,75305995,124823094,84823094,True
1408,9,2005-04-01,sin city,40000000,74103820,158527918,118527918,True
1409,10,2015-10-16,bridge of spies,40000000,72313754,162498338,122498338,True
1410,11,2008-02-22,vantage point,40000000,72266306,150886329,110886329,True
1411,12,2009-03-20,"i love you, man",40000000,72013010,92302502,52302502,True
1412,13,2001-11-09,shallow hal,40000000,70836296,70836296,30836296,True
1413,14,1991-12-20,jfk,40000000,70405498,205400000,165400000,True
1414,15,2006-01-27,big momma's house 2,40000000,70165972,137047376,97047376,True
1415,16,2018-09-21,the house with a clock in its walls,40000000,68549695,126331750,86331750,True
1416,17,2016-11-04,hacksaw ridge,40000000,67209615,168904682,128904682,True
1417,18,2001-03-02,the mexican,40000000,66808615,145238250,105238250,True
1418,19,2009-08-28,the final destination,40000000,66477700,187384627,147384627,True
1419,20,2009-04-17,17 again,40000000,64167069,139474906,99474906,True
1420,21,2011-02-18,unknown,40000000,63686397,136123083,96123083,True
1421,22,2010-06-04,get him to the greek,40000000,61153526,91455875,51455875,True
1422,23,2003-11-21,gothika,40000000,59588068,141484812,101484812,True
1423,24,2001-11-30,behind enemy lines,40000000,58855732,58855732,18855732,True
1424,25,2011-03-18,the lincoln lawyer,40000000,58009200,87145086,47145086,True
1425,26,2004-10-15,shall we dance?,40000000,57887882,118097882,78097882,True
1426,27,2006-08-25,invincible,40000000,57806952,58501127,18501127,True
1427,28,2013-02-15,escape from planet earth,40000000,57012977,74156610,34156610,True
1428,29,1998-07-10,small soldiers,40000000,55143823,71743823,31743823,True
1429,30,1997-07-31,spawn,40000000,54979992,87949859,47949859,True
1430,31,2014-11-26,horrible bosses 2,40000000,54445357,105945357,65945357,True
1431,32,2002-01-25,the count of monte cristo,40000000,54228104,75389090,35389090,True
1432,33,2006-10-20,the prestige,40000000,53089891,104407366,64407366,True
1433,34,2006-06-16,the lake house,40000000,52330111,114830111,74830111,True
1434,35,2010-07-09,predators,40000000,52000688,127234389,87234389,True
1435,36,2012-08-15,the odd life of timothy green,40000000,51853450,55249159,15249159,True
1436,37,1987-07-31,the living daylights,40000000,51185000,191200000,151200000,True
1437,38,2006-12-08,apocalypto,40000000,50866635,121032272,81032272,True
1438,39,2007-02-14,music and lyrics,40000000,50572589,146196885,106196885,True
1439,40,1986-06-18,legal eagles,40000000,49851591,49851591,9851591,True
1440,41,2004-03-12,secret window,40000000,47958031,92111551,52111551,True
1441,42,2005-08-12,the skeleton key,40000000,47907715,92256918,52256918,True
1442,43,2014-06-20,jersey boys,40000000,47047013,65282732,25282732,True
1443,44,2008-05-02,made of honor,40000000,46012734,106548738,66548738,True
1444,45,1997-11-21,the rainmaker,40000000,45916769,45916769,5916769,True
1445,46,1992-02-07,medicine man,40000000,44948240,44948240,4948240,True
1446,47,1997-12-12,amistad,40000000,44212592,58250151,18250151,True
1447,48,2014-05-30,a million ways to die in the west,40000000,42720965,86778557,46778557,True
1448,49,2011-08-12,final destination 5,40000000,42587643,155011165,115011165,True
1449,50,2018-11-16,widows,40000000,42402632,73866088,33866088,True
1450,51,2005-04-08,fever pitch,40000000,42071069,50071069,10071069,True
1451,52,2007-12-25,aliens vs. predator - requiem,40000000,41797066,128884494,88884494,True
1452,53,2007-12-25,the water horse: legend of the deep,40000000,40412817,103429755,63429755,True
1453,54,2014-07-18,sex tape,40000000,38543473,126069509,86069509,False
1454,55,2011-04-15,scream 4,40000000,38180928,95989590,55989590,False
1455,56,1994-12-21,ri¢hie ri¢h,40000000,38087756,38087756,-1912244,False
1456,57,2000-08-11,autumn in new york,40000000,37752931,90717684,50717684,False
1457,58,2011-03-18,paul,40000000,37412945,101162106,61162106,False
1458,59,2012-12-19,the guilt trip,40000000,37134215,41294674,1294674,False
1459,60,2011-08-26,colombiana,40000000,36665854,72295262,32295262,False
1460,61,1999-02-26,8mm,40000000,36443442,96398826,56398826,False
1461,62,2018-01-12,the commuter,40000000,36343858,101985431,61985431,False
1462,63,2000-02-18,hanging up,40000000,36037909,51867723,11867723,False
1463,64,1991-03-01,the doors,40000000,34416893,34416893,-5583107,False
1464,65,1999-08-20,mickey blue eyes,40000000,33864342,53864342,13864342,False
1465,66,2000-10-20,pay it forward,40000000,33508922,55696705,15696705,False
1466,67,2011-04-08,arthur,40000000,33035397,47787943,7787943,False
1467,68,2008-03-21,drillbit taylor,40000000,32862104,49686263,9686263,False
1468,69,2016-12-21,patriots day,40000000,31886361,52837989,12837989,False
1469,70,2011-12-25,extremely loud and incredibly close,40000000,31847881,55247881,15247881,False
1470,71,1994-07-01,the shadow,40000000,31835600,31835600,-8164400,False
1471,72,2008-11-26,transporter 3,40000000,31715062,107235592,67235592,False
1472,73,2010-11-10,morning glory,40000000,31011732,59795070,19795070,False
1473,74,2005-11-09,get rich or die tryin',40000000,30981850,46666955,6666955,False
1474,75,2019-05-03,long shot,40000000,30202860,43711031,3711031,False
1475,76,2000-08-25,the art of war,40000000,30199105,30199105,-9800895,False
1476,77,2013-12-25,grudge match,40000000,29807260,69807260,29807260,False
1477,78,2000-08-11,bless the child,40000000,29374178,40435694,435694,False
1478,79,2005-11-23,rent,40000000,29077547,31670620,-8329380,False
1479,80,1999-04-02,the out-of-towners,40000000,28544120,28544120,-11455880,False
1480,81,2017-08-11,the nut job 2: nutty by nature,40000000,28370522,57438389,17438389,False
1481,82,1996-08-23,the island of dr. moreau,40000000,27682712,27682712,-12317288,False
1482,83,2001-09-07,the musketeer,40000000,27053815,27053815,-12946185,False
1483,84,2017-01-27,resident evil: the final chapter,40000000,26844692,314101190,274101190,False
1484,85,2008-02-29,the other boleyn girl,40000000,26814957,78269970,38269970,False
1485,86,2017-06-30,the house,40000000,25584504,31192425,-8807575,False
1486,87,2001-02-16,sweet november,40000000,25288103,65754228,25754228,False
1487,88,2007-04-05,the reaping,40000000,25126214,62226214,22226214,False
1488,89,2011-01-07,season of the witch,40000000,24827228,91126600,51126600,False
1489,90,1994-06-03,renaissance man,40000000,24172899,24172899,-15827101,False
1490,91,1998-05-15,quest for camelot,40000000,22772500,38172500,-1827500,False
1491,92,2002-09-06,city by the sea,40000000,22433915,22433915,-17566085,False
1492,93,1999-01-15,at first sight,40000000,22365133,22365133,-17634867,False
1493,94,2016-08-26,mechanic: resurrection,40000000,21218403,109738840,69738840,False
1494,95,2004-01-16,torque,40000000,21176322,46176322,6176322,False
1495,96,2009-11-13,fantastic mr. fox,40000000,21002919,47083412,7083412,False
1496,97,1995-09-22,showgirls,40000000,20350754,37750754,-2249246,False
1497,98,1996-02-16,city hall,40000000,20278055,20278055,-19721945,False
1498,99,2012-02-03,big miracle,40000000,20157300,25268680,-14731320,False
1499,100,2012-12-21,the impossible,40000000,19019882,169590606,129590606,False
1500,1,2012-03-09,a thousand words,40000000,18450127,20790486,-19209514,False
1501,2,2006-10-20,marie antoinette,40000000,15962471,60862471,20862471,False
1502,3,2000-10-06,get carter,40000000,14967182,19417182,-20582818,False
1503,4,1995-04-21,kiss of death,40000000,14942422,14942422,-25057578,False
1504,5,2002-04-26,"life, or something like it",40000000,14448589,14448589,-25551411,False
1505,6,1987-05-15,ishtar,40000000,14375181,14375181,-25624819,False
1506,7,1992-02-28,memoirs of an invisible man,40000000,14358033,14358033,-25641967,False
1507,8,2009-10-23,amelia,40000000,14279575,19756077,-20243923,False
1508,9,2009-10-23,cirque du freak: the vampire's assistant,40000000,14046595,39753957,-246043,False
1509,10,2004-05-07,new york minute,40000000,14018364,21215882,-18784118,False
1510,11,1999-03-12,the deep end of the ocean,40000000,13508635,13508635,-26491365,False
1511,12,2004-11-05,alfie,40000000,13395939,35195939,-4804061,False
1512,13,2002-08-30,feardotcom,40000000,13208023,13208023,-26791977,False
1513,14,2008-11-07,soul men,40000000,12082391,12345883,-27654117,False
1514,15,2015-03-20,the gunman,40000000,10664749,18594227,-21405773,False
1515,16,1999-08-20,universal soldier ii: the return,40000000,10447421,10717421,-29282579,False
1516,17,2009-09-25,pandorum,40000000,10330853,17033431,-22966569,False
1517,18,2003-09-26,duplex,40000000,9652000,10070651,-29929349,False
1518,19,2013-08-16,paranoia,40000000,7388654,16340767,-23659233,False
1519,20,1980-08-01,raise the titanic,40000000,7000000,7000000,-33000000,False
1520,21,2015-07-10,baahubali: the beginning,40000000,6738000,26736665,-13263335,False
1521,22,2018-03-09,the hurricane heist,40000000,6115824,30963684,-9036316,False
1522,23,2002-01-04,impostor,40000000,6114237,7974607,-32025393,False
1523,24,2015-11-25,victor frankenstein,40000000,5775076,31124367,-8875633,False
1524,25,2002-11-27,extreme ops,40000000,4835968,12624471,-27375529,False
1525,26,2001-04-06,just visiting,40000000,4777007,16172200,-23827800,False
1526,27,2014-06-27,snowpiercer,40000000,4563029,88069880,48069880,False
1527,28,2007-07-20,sunshine,40000000,3688560,32030610,-7969390,False
1528,29,1994-03-11,the hudsucker proxy,40000000,2816518,14938149,-25061851,False
1529,30,2016-11-11,billy lynnâs long halftime walk,40000000,1738477,30230402,-9769598,False
1530,31,1986-07-01,pirates,40000000,1641825,6341825,-33658175,False
1531,32,2008-12-12,delgo,40000000,915840,915840,-39084160,False
1532,33,2007-09-07,the hunting party,40000000,876671,7729552,-32270448,False
1533,34,2006-10-13,alex rider: operation stormbreaker,40000000,659210,20722450,-19277550,False
1534,35,2009-11-20,red cliff,40000000,627047,119627047,79627047,False
1535,36,2004-09-24,the last shot,40000000,463730,463730,-39536270,False
1536,37,2007-03-16,nomad,40000000,79123,79123,-39920877,False
1537,38,2013-04-16,un monstre ã paris,40000000,0,27000381,-12999619,False
1538,39,2019-06-21,kursk,40000000,0,4212799,-35787201,False
1539,40,2016-11-11,uss indianapolis: men of courage,40000000,0,1663785,-38336215,False
1540,41,2014-12-31,dragon nest warriors' dawn,40000000,0,734423,-39265577,False
1541,42,2018-12-31,the crow,40000000,0,0,-40000000,False
1542,43,2019-09-13,the goldfinch,40000000,0,0,-40000000,False
1543,44,2019-12-31,down under cover,40000000,0,0,-40000000,False
1544,45,2009-08-14,the time traveler's wife,39000000,63414846,102332135,63332135,True
1545,46,1983-06-17,superman iii,39000000,59950623,59950623,20950623,True
1546,47,2007-02-02,because i said so,39000000,42674040,69538833,30538833,True
1547,48,2012-10-05,frankenweenie,39000000,35287788,81150788,42150788,False
1548,49,1996-03-29,sgt. bilko,39000000,30356589,37956589,-1043411,False
1549,50,2005-09-30,serenity,39000000,25514517,40319440,1319440,False
1550,51,2007-09-07,shoot 'em up,39000000,12796824,26796824,-12203176,False
1551,52,2004-02-20,against the ropes,39000000,5881504,6429865,-32570135,False
1552,53,2013-08-23,yi dai zong shi,38600000,6594959,57987299,19387299,False
1553,54,2001-06-22,the fast and the furious,38000000,144512310,206512310,168512310,True
1554,55,2002-09-27,sweet home alabama,38000000,127214072,182365114,144365114,True
1555,56,2009-07-24,the ugly truth,38000000,88915214,205298907,167298907,True
1556,57,2002-08-07,spy kids 2: the island of lost dreams,38000000,85846296,119721296,81721296,True
1557,58,1994-11-18,star trek: generations,38000000,75671262,120000000,82000000,True
1558,59,2017-06-02,captain underpants: the first epic movie,38000000,73921000,126577874,88577874,True
1559,60,2015-04-17,paul blart: mall cop 2,38000000,71091594,107650646,69650646,True
1560,61,1997-12-19,mouse hunt,38000000,61894591,61894591,23894591,True
1561,62,2016-12-23,why him?,38000000,60323786,117425156,79425156,True
1562,63,2011-04-22,water for elephants,38000000,58709717,116809717,78809717,True
1563,64,2010-10-08,life as we know it,38000000,53374681,105887837,67887837,True
1564,65,1999-12-29,the hurricane,38000000,50699241,73956241,35956241,True
1565,66,2013-09-06,riddick,38000000,42025135,94763758,56763758,True
1566,67,2001-03-23,heartbreakers,38000000,40334024,57753825,19753825,True
1567,68,2002-05-24,enough,38000000,39177215,50970660,12970660,True
1568,69,2016-01-22,the 5th wave,38000000,34912982,111336398,73336398,False
1569,70,2009-02-06,push,38000000,31811527,49678401,11678401,False
1570,71,2013-09-20,rush,38000000,26947624,98230839,60230839,False
1571,72,2001-05-18,angel eyes,38000000,24044532,29544532,-8455468,False
1572,73,2001-12-21,joe somebody,38000000,22770864,24515990,-13484010,False
1573,74,2000-03-10,the ninth gate,38000000,18653746,58394308,20394308,False
1574,75,2017-10-20,only the brave,38000000,18340051,24555177,-13444823,False
1575,76,1996-09-27,extreme measures,38000000,17378193,17378193,-20621807,False
1576,77,2011-10-14,the thing,38000000,16999934,27573078,-10426922,False
1577,78,2001-09-07,rock star,38000000,16991902,19317765,-18682235,False
1578,79,1996-02-02,white squall,38000000,10229300,10229300,-27770700,False
1579,80,2008-10-10,city of ember,38000000,7873007,17831558,-20168442,False
1580,81,1997-10-31,switchback,38000000,6504442,6504442,-31495558,False
1581,82,2018-09-21,the sisters brothers,38000000,3143056,13143056,-24856944,False
1582,83,2001-11-30,texas rangers,38000000,623374,623374,-37376626,False
1583,84,2008-08-26,virgin territory,38000000,0,5473041,-32526959,False
1584,85,2019-01-11,the upside,37500000,108235497,119024536,81524536,True
1585,86,2012-05-18,what to expect when you're expecting,37500000,41152203,88473016,50973016,True
1586,87,2012-09-14,the master,37500000,16247159,50647416,13147416,False
1587,88,2008-10-10,the express,37500000,9793406,9813309,-27686691,False
1588,89,2008-11-21,twilight,37000000,192769854,402280159,365280159,True
1589,90,2013-08-07,we're the millers,37000000,150394119,267816276,230816276,True
1590,91,2015-11-25,creed,37000000,109767581,173567581,136567581,True
1591,92,2010-09-17,the town,37000000,92186262,152566881,115566881,True
1592,93,2011-09-23,dolphin tale,37000000,72286779,96068724,59068724,True
1593,94,2018-02-23,game night,37000000,69179066,117378084,80378084,True
1594,95,2008-09-12,burn after reading,37000000,60355347,168167798,131167798,True
1595,96,2004-04-23,13 going on 30,37000000,57139723,97658712,60658712,True
1596,97,2008-04-04,nim's island,37000000,48006762,101857425,64857425,True
1597,98,2016-02-12,how to be single,37000000,46843513,100003780,63003780,True
1598,99,2010-02-26,cop out,37000000,44875481,55909910,18909910,True
1599,100,2011-01-28,the rite,37000000,33047633,97143987,60143987,False
1600,1,2008-07-18,space chimps,37000000,30105968,67029956,30029956,False
1601,2,1999-12-17,magnolia,37000000,22450975,48446802,11446802,False
1602,3,2015-05-29,aloha,37000000,21052030,25387091,-11612909,False
1603,4,2009-12-31,obitaemyy ostrov,36500000,0,15000000,-21500000,False
1604,5,2018-10-05,a star is born,36000000,215288866,433449571,397449571,True
1605,6,2011-02-11,gnomeo and juliet,36000000,99967670,193737977,157737977,True
1606,7,2002-02-15,john q,36000000,71026631,102226631,66226631,True
1607,8,1999-09-17,blue streak,36000000,68208190,117448157,81448157,True
1608,9,1983-10-07,never say never again,36000000,55500000,160000000,124000000,True
1609,10,2010-03-26,hot tub time machine,36000000,50269859,65967750,29967750,True
1610,11,1997-05-02,breakdown,36000000,50159144,50159144,14159144,True
1611,12,2014-09-12,dolphin tale 2,36000000,42024533,57824533,21824533,True
1612,13,2016-12-16,collateral beauty,36000000,31016021,85309093,49309093,False
1613,14,2003-04-04,a man apart,36000000,26500000,43797731,7797731,False
1614,15,2000-02-25,reindeer games,36000000,23360779,23360779,-12639221,False
1615,16,1999-12-24,snow falling on cedars,36000000,14378353,14378353,-21621647,False
1616,17,1996-12-20,ghosts of mississippi,36000000,13052741,13052741,-22947259,False
1617,18,1997-10-24,gattaca,36000000,12532777,12532777,-23467223,False
1618,19,2000-01-28,isn't she great,36000000,2954405,2954405,-33045595,False
1619,20,2016-01-22,yip man 3,36000000,2679437,157300954,121300954,False
1620,21,2011-05-06,there be dragons,36000000,1069334,4020990,-31979010,False
1621,22,2017-04-14,queen of the desert,36000000,0,1578543,-34421457,False
1622,23,2003-03-28,head of state,35200000,37788228,38283765,3083765,True
1623,24,2017-09-08,it,35000000,327481748,697457969,662457969,True
1624,25,2009-06-05,the hangover,35000000,277322503,465764086,430764086,True
1625,26,2009-11-20,the blind side,35000000,255959475,305705794,270705794,True
1626,27,1989-06-23,batman,35000000,251188924,411348924,376348924,True
1627,28,1999-06-10,austin powers: the spy who shagged me,35000000,206040085,312383487,277383487,True
1628,29,2010-12-22,true grit,35000000,171243005,252276928,217276928,True
1629,30,1992-05-15,lethal weapon 3,35000000,144731527,319700000,284700000,True
1630,31,1998-09-18,rush hour,35000000,141186864,245300000,210300000,True
1631,32,2013-02-08,identity thief,35000000,134506920,175361578,140361578,True
1632,33,2006-06-30,the devil wears prada,35000000,124740460,326073155,291073155,True
1633,34,2011-07-08,horrible bosses,35000000,117538559,212417601,177417601,True
1634,35,2001-03-30,spy kids,35000000,112692062,197692062,162692062,True
1635,36,2015-07-17,trainwreck,35000000,110212700,141123897,106123897,True
1636,37,2013-12-13,saving mr. banks,35000000,83299761,114962525,79962525,True
1637,38,1979-12-07,star trek: the motion picture,35000000,82258456,139000000,104000000,True
1638,39,2008-03-28,21,35000000,81159365,159846429,124846429,True
1639,40,2008-05-09,what happens in vegas...,35000000,80277646,218535708,183535708,True
1640,41,1991-11-15,cape fear,35000000,79091969,182291969,147291969,True
1641,42,1996-11-15,the english patient,35000000,78716374,231710008,196710008,True
1642,43,2009-01-16,hotel for dogs,35000000,73178547,122357172,87357172,True
1643,44,2005-03-25,guess who,35000000,68915888,102115888,67115888,True
1644,45,2012-12-21,this is 40,35000000,67544505,90221182,55221182,True
1645,46,1997-09-19,l.a. confidential,35000000,64604977,126204977,91204977,True
1646,47,2005-07-29,sky high,35000000,63939454,83109359,48109359,True
1647,48,1997-09-19,in & out,35000000,63826569,83226569,48226569,True
1648,49,2010-04-30,a nightmare on elm street,35000000,63075011,117729621,82729621,True
1649,50,2000-08-18,the cell,35000000,61280963,85911226,50911226,True
1650,51,1995-07-07,species,35000000,60054449,113354449,78354449,True
1651,52,2006-04-07,the benchwarmers,35000000,59843754,65063726,30063726,True
1652,53,2010-10-08,secretariat,35000000,59699513,60376247,25376247,True
1653,54,1998-03-13,the man in the iron mask,35000000,56968169,56968169,21968169,True
1654,55,2011-07-22,friends with benefits,35000000,55802754,146595891,111595891,True
1655,56,2016-05-20,neighbors 2: sorority rising,35000000,55340730,108757621,73757621,True
1656,57,2007-03-23,tmnt,35000000,54149098,96096018,61096018,True
1657,58,2003-10-24,radio,35000000,52333738,53293628,18293628,True
1658,59,2018-06-29,sicario: day of the soldado,35000000,50065850,75885196,40885196,True
1659,60,2009-11-25,old dogs,35000000,49492060,95104304,60104304,True
1660,61,1992-11-18,malcolm x,35000000,48169910,48169910,13169910,True
1661,62,2015-05-22,poltergeist,35000000,47425125,95713069,60713069,True
1662,63,2018-10-12,goosebumps 2: haunted halloween,35000000,46697321,93291478,58291478,True
1663,64,2018-01-19,12 strong,35000000,45819713,71118378,36118378,True
1664,65,2009-01-23,underworld 3: rise of the lycans,35000000,45802315,89102315,54102315,True
1665,66,2005-07-29,must love dogs,35000000,43894863,58405313,23405313,True
1666,67,2007-07-03,license to wed,35000000,43799818,70187088,35187088,True
1667,68,1997-02-28,donnie brasco,35000000,41954997,65303052,30303052,True
1668,69,2008-10-17,max payne,35000000,40689393,87775050,52775050,True
1669,70,2002-03-15,resident evil,35000000,40119709,103787401,68787401,True
1670,71,2004-03-26,the ladykillers,35000000,39692139,77392139,42392139,True
1671,72,2011-05-06,something borrowed,35000000,39046489,65084116,30084116,True
1672,73,2006-12-01,the nativity story,35000000,37629831,46309644,11309644,True
1673,74,2011-10-28,in time,35000000,37553932,165103952,130103952,True
1674,75,2010-04-23,the back-up plan,35000000,37490007,75281179,40281179,True
1675,76,2011-11-09,j. edgar,35000000,37306030,84606030,49606030,True
1676,77,2000-11-17,bounce,35000000,36805288,53425292,18425292,True
1677,78,2018-08-17,mile 22,35000000,36108758,66295121,31295121,True
1678,79,2015-05-08,hot pursuit,35000000,34580201,45671512,10671512,False
1679,80,2015-12-25,concussion,35000000,34531832,50363790,15363790,False
1680,81,2017-10-13,the foreigner,35000000,34393507,140783360,105783360,False
1681,82,2004-12-03,closer,35000000,33987757,116177695,81177695,False
1682,83,1994-12-23,street fighter,35000000,33423000,99423000,64423000,False
1683,84,2001-11-21,black knight,35000000,33422806,33422806,-1577194,False
1684,85,2005-07-22,the bad news bears,35000000,32868349,33500620,-1499380,False
1685,86,2002-12-27,the pianist,35000000,32519322,111854182,76854182,False
1686,87,2005-05-06,house of wax,35000000,32064800,70064800,35064800,False
1687,88,2001-10-19,from hell,35000000,31598308,68712365,33712365,False
1688,89,2018-06-01,adrift,35000000,31445011,57897191,22897191,False
1689,90,2008-08-15,mirrors,35000000,30691439,77220596,42220596,False
1690,91,2017-01-06,underworld: blood wars,35000000,30353973,81209222,46209222,False
1691,92,2002-02-22,queen of the damned,35000000,30307804,30307804,-4692196,False
1692,93,2010-08-20,nanny mcphee and the big bang,35000000,29197642,97799865,62799865,False
1693,94,2008-01-25,untraceable,35000000,28687835,52649951,17649951,False
1694,95,1990-11-21,predator 2,35000000,28317513,54768418,19768418,False
1695,96,2011-09-23,abduction,35000000,28087155,86648359,51648359,False
1696,97,1980-12-05,flash gordon,35000000,27107960,27107960,-7892040,False
1697,98,2008-03-28,superhero movie,35000000,26638520,73026302,38026302,False
1698,99,1999-02-12,blast from the past,35000000,26613620,26613620,-8386380,False
1699,100,2012-10-19,alex cross,35000000,25888412,35426759,426759,False
1700,1,2004-03-26,jersey girl,35000000,25266129,37066129,2066129,False
1701,2,1997-11-21,midnight in the garden of good and evil,35000000,25078937,25078937,-9921063,False
1702,3,2016-09-16,bridget jonesâs baby,35000000,24139805,205822688,170822688,False
1703,4,2001-11-09,heist,35000000,23483357,28906817,-6093183,False
1704,5,1992-12-25,hoffa,35000000,23365858,28391473,-6608527,False
1705,6,2016-03-04,whiskey tango foxtrot,35000000,23083334,25350747,-9649253,False
1706,7,2004-04-09,ella enchanted,35000000,22913677,22913677,-12086323,False
1707,8,2015-08-21,hitman: agent 47,35000000,22467450,82182803,47182803,False
1708,9,2008-07-25,the x-files: i want to believe,35000000,20982478,68170792,33170792,False
1709,10,2012-08-24,premium rush,35000000,20275446,31393201,-3606799,False
1710,11,2013-01-18,broken city,35000000,19701164,34480045,-519955,False
1711,12,2005-08-19,valiant,35000000,19478106,64188387,29188387,False
1712,13,2000-02-23,wonder boys,35000000,19389454,33422485,-1577515,False
1713,14,2005-02-25,cursed,35000000,19294901,25114901,-9885099,False
1714,15,2007-12-21,walk hard: the dewey cox story,35000000,18317151,20606053,-14393947,False
1715,16,2002-09-20,the four feathers,35000000,18306166,29882645,-5117355,False
1716,17,2010-04-30,furry vengeance,35000000,17630465,39340177,4340177,False
1717,18,2013-01-25,parker,35000000,17616641,48543388,13543388,False
1718,19,2004-09-17,wimbledon,35000000,16862585,41666476,6666476,False
1719,20,2000-09-15,bait,35000000,15325127,15471969,-19528031,False
1720,21,2000-12-08,dungeons and dragons,35000000,15185241,33771965,-1228035,False
1721,22,2007-11-09,lions for lambs,35000000,14998070,63211088,28211088,False
1722,23,1991-01-18,flight of the intruder,35000000,14471440,14471440,-20528560,False
1723,24,2011-05-27,the tree of life,35000000,13305665,61721826,26721826,False
1724,25,2001-08-17,american outlaws,35000000,13264986,13601109,-21398891,False
1725,26,2006-08-11,zoom,35000000,11989328,12506188,-22493812,False
1726,27,2001-12-25,the shipping news,35000000,11405825,24405825,-10594175,False
1727,28,2009-12-18,the young victoria,35000000,11001272,31878891,-3121109,False
1728,29,2014-03-28,sabotage,35000000,10508518,18376443,-16623557,False
1729,30,1998-09-04,knock off,35000000,10319915,10319915,-24680085,False
1730,31,2009-09-11,whiteout,35000000,10275638,12254746,-22745254,False
1731,32,2015-03-06,unfinished business,35000000,10219501,13214051,-21785949,False
1732,33,2015-09-30,the walk,35000000,10161183,61492104,26492104,False
1733,34,2006-11-22,the fountain,35000000,10144010,15461638,-19538362,False
1734,35,2013-11-29,mandela: long walk to freedom,35000000,8323085,29890402,-5109598,False
1735,36,2008-12-05,punisher: war zone,35000000,8050977,10157534,-24842466,False
1736,37,2003-09-05,the order,35000000,7659747,11559747,-23440253,False
1737,38,2006-11-10,a good year,35000000,7459300,42064105,7064105,False
1738,39,2016-03-11,the brothers grimsby,35000000,6864016,28720470,-6279530,False
1739,40,2017-10-20,the snowman,35000000,6670765,43226146,8226146,False
1740,41,2002-11-06,femme fatale,35000000,6630252,16830252,-18169748,False
1741,42,1997-05-02,warriors of virtue,35000000,6448817,6448817,-28551183,False
1742,43,2003-09-26,luther,35000000,5781086,32717063,-2282937,False
1743,44,2011-01-28,biutiful,35000000,5101237,24687524,-10312476,False
1744,45,1992-02-21,radio flyer,35000000,4651977,4651977,-30348023,False
1745,46,1993-04-16,bound by honor,35000000,4496583,4496583,-30503417,False
1746,47,2016-04-22,a hologram for the king,35000000,4212494,11846010,-23153990,False
1747,48,1997-02-28,smilla's sense of snow,35000000,2221994,2221994,-32778006,False
1748,49,1986-10-03,playing for keeps,35000000,2000000,2000000,-33000000,False
1749,50,1980-01-01,lion of the desert,35000000,1500000,1500000,-33500000,False
1750,51,1996-04-19,le hussard sur le toit,35000000,1320043,1320043,-33679957,False
1751,52,1999-11-24,ride with the devil,35000000,630779,630779,-34369221,False
1752,53,2012-09-14,stolen,35000000,289773,17967746,-17032254,False
1753,54,2011-10-14,trespass,35000000,16816,786532,-34213468,False
1754,55,2006-09-22,bandidas,35000000,0,19282590,-15717410,False
1755,56,2015-03-13,the lovers,35000000,0,53899,-34946101,False
1756,57,2008-12-31,black water transit,35000000,0,0,-35000000,False
1757,58,2011-12-25,the darkest hour,34800000,21443494,62831715,28031715,False
1758,59,2017-06-28,baby driver,34000000,107825862,228104185,194104185,True
1759,60,2014-09-19,the maze runner,34000000,102427862,348319861,314319861,True
1760,61,2015-04-10,the longest ride,34000000,37446117,63802928,29802928,True
1761,62,1993-09-17,the age of innocence,34000000,32014993,32014993,-1985007,False
1762,63,2009-08-14,gake no ue no ponyo,34000000,15090399,205312666,171312666,False
1763,64,2018-08-03,the darkest minds,34000000,12695691,38361428,4361428,False
1764,65,1999-09-01,chill factor,34000000,11263966,11263966,-22736034,False
1765,66,1999-08-27,the astronaut's wife,34000000,10672566,10672566,-23327434,False
1766,67,2000-05-05,i dreamed of africa,34000000,6543194,14291999,-19708001,False
1767,68,2014-09-05,thunder and the house of magic,34000000,4091,62582520,28582520,False
1768,69,1981-12-04,reds,33500000,50000000,50000000,16500000,True
1769,70,1992-12-11,a few good men,33000000,141340178,236500000,203500000,True
1770,71,2000-06-02,big momma's house,33000000,117559438,173559438,140559438,True
1771,72,2001-03-16,exit wounds,33000000,51758599,79958599,46958599,True
1772,73,2016-07-08,mike and dave need wedding dates,33000000,46009673,75898100,42898100,True
1773,74,2012-07-27,step up revolution,33000000,35074677,165552290,132552290,True
1774,75,2006-08-18,snakes on a plane,33000000,34020814,62020814,29020814,True
1775,76,2004-04-16,the punisher,33000000,33664370,54533774,21533774,True
1776,77,2000-09-08,the watcher,33000000,28946615,47267829,14267829,False
1777,78,2012-04-27,safe,33000000,17142080,41495213,8495213,False
1778,79,2008-03-14,doomsday,33000000,11008770,21621188,-11378812,False
1779,80,1999-04-23,pushing tin,33000000,8408835,8408835,-24591165,False
1780,81,2006-05-12,goal! the dream begins,33000000,4283255,27610873,-5389127,False
1781,82,2015-07-31,the young and prodigious t.s. spivet,33000000,176847,357687,-32642313,False
1782,83,2015-10-30,freaks of nature,33000000,70958,70958,-32929042,False
1783,84,1983-05-25,star wars ep. vi: return of the jedi,32500000,309205079,572705079,540205079,True
1784,85,2011-05-13,bridesmaids,32500000,169211718,289632023,257132023,True
1785,86,2008-12-10,the reader,32500000,34194407,112964875,80464875,True
1786,87,2013-04-26,the big wedding,32500000,21819348,48425971,15925971,False
1787,88,2012-02-24,wanderlust,32500000,17288155,24159934,-8340066,False
1788,89,2003-11-07,elf,32000000,173840591,220678483,188678483,True
1789,90,1996-07-05,phenomenon,32000000,104636382,152036382,120036382,True
1790,91,2013-06-12,this is the end,32000000,101470202,126539117,94539117,True
1791,92,2002-01-18,snow dogs,32000000,81150692,116898028,84898028,True
1792,93,2006-06-16,nacho libre,32000000,80197993,99296462,67296462,True
1793,94,1988-11-23,scrooged,32000000,59450353,59450353,27450353,True
1794,95,2010-08-27,takers,32000000,57744720,70587268,38587268,True
1795,96,2011-04-01,source code,32000000,54712227,140428499,108428499,True
1796,97,1999-09-10,stigmata,32000000,50041732,89441732,57441732,True
1797,98,2000-11-10,men of honor,32000000,48814909,82339483,50339483,True
1798,99,2018-04-20,i feel pretty,32000000,48795601,91553797,59553797,True
1799,100,2005-09-02,the transporter 2,32000000,43095856,88978458,56978458,True
1800,1,2011-02-18,"big mommas: like father, like son",32000000,37915414,82332450,50332450,True
1801,2,1993-01-15,alive,32000000,36299670,36299670,4299670,True
1802,3,2007-02-23,the number 23,32000000,35193167,77593167,45593167,True
1803,4,1979-12-14,1941,32000000,34175000,94875000,62875000,True
1804,5,2005-10-21,dreamer: inspired by a true story,32000000,33022286,39498360,7498360,True
1805,6,2005-09-23,a history of violence,32000000,31493782,61477797,29477797,False
1806,7,2013-03-15,the incredible burt wonderstone,32000000,22537881,27392609,-4607391,False
1807,8,1995-02-10,the quick and the dead,32000000,18552460,18552460,-13447540,False
1808,9,2004-04-30,laws of attraction,32000000,17848322,29948322,-2051678,False
1809,10,2018-10-12,bad times at the el royale,32000000,17839115,29204379,-2795621,False
1810,11,2010-09-03,going the distance,32000000,17804299,43603990,11603990,False
1811,12,1999-10-22,bringing out the dead,32000000,16640210,16640210,-15359790,False
1812,13,2010-03-19,repo men,32000000,13942007,18195238,-13804762,False
1813,14,2007-09-14,dragon wars: d-war,32000000,10977721,79915361,47915361,False
1814,15,1996-09-06,bogus,32000000,4357406,4357406,-27642594,False
1815,16,1997-03-26,cats don't dance,32000000,3588602,3588602,-28411398,False
1816,17,1999-12-08,cradle will rock,32000000,2899970,2899970,-29100030,False
1817,18,2006-12-15,the good german,32000000,1308696,6678033,-25321967,False
1818,19,2004-12-31,george and the dragon,32000000,0,0,-32000000,False
1819,20,1979-08-15,apocalypse now,31500000,78800000,81250485,49750485,True
1820,21,2016-04-15,criminal,31500000,14708696,38771262,7271262,False
1821,22,2013-04-12,42,31000000,95020213,97470701,66470701,True
1822,23,2012-11-02,flight,31000000,93772375,160558438,129558438,True
1823,24,1995-12-29,mr. hollandâs opus,31000000,82582604,106282604,75282604,True
1824,25,1985-12-18,out of africa,31000000,79096868,258210860,227210860,True
1825,26,1979-06-29,moonraker,31000000,70300000,210300000,179300000,True
1826,27,2014-03-07,the grand budapest hotel,31000000,59076019,163981261,132981261,True
1827,28,2015-07-29,vacation,31000000,58884188,102306500,71306500,True
1828,29,1990-07-18,arachnophobia,31000000,53208180,53208180,22208180,True
1829,30,2019-02-13,isnât it romantic,31000000,48791187,48791187,17791187,True
1830,31,2000-04-28,frequency,31000000,44983704,68079671,37079671,True
1831,32,2001-09-28,hearts in atlantis,31000000,24185781,30885781,-114219,False
1832,33,2010-01-22,extraordinary measures,31000000,12482741,15826984,-15173016,False
1833,34,2017-08-25,birth of the dragon,31000000,6901965,7220490,-23779510,False
1834,35,1995-10-20,get shorty,30250000,72021008,115021008,84771008,True
1835,36,1984-06-08,ghostbusters,30000000,242212467,295212467,265212467,True
1836,37,1995-11-22,toy story,30000000,191796233,364545516,334545516,True
1837,38,2018-08-15,crazy rich asians,30000000,174532921,238099711,208099711,True
1838,39,2002-12-27,chicago,30000000,170687518,306770545,276770545,True
1839,40,1999-06-25,big daddy,30000000,163479795,228641283,198641283,True
1840,41,2001-08-10,american pie 2,30000000,145096820,286500000,256500000,True
1841,42,2012-02-10,the vow,30000000,125014030,197618160,167618160,True
1842,43,1994-06-10,speed,30000000,121248145,283200000,253200000,True
1843,44,1990-03-02,the hunt for red october,30000000,120709866,200500000,170500000,True
1844,45,2013-08-16,lee daniels' the butler,30000000,116632095,177025498,147025498,True
1845,46,2000-09-29,remember the titans,30000000,115654751,136706683,106706683,True
1846,47,2009-08-14,district 9,30000000,115646235,212453431,182453431,True
1847,48,2004-06-18,dodgeball: a true underdog story,30000000,114326736,167791704,137791704,True
1848,49,1991-11-22,the addams family,30000000,113502246,191502246,161502246,True
1849,50,1995-11-10,ace ventura: when nature calls,30000000,108360063,212400000,182400000,True
1850,51,2001-08-03,the princess diaries,30000000,108244774,165334774,135334774,True
1851,52,1999-03-05,analyze this,30000000,106885658,176885658,146885658,True
1852,53,1996-09-20,the first wives club,30000000,105489203,181489203,151489203,True
1853,54,2004-12-15,million dollar baby,30000000,100492203,231928227,201928227,True
1854,55,1995-09-22,se7en,30000000,100125643,328125643,298125643,True
1855,56,2003-10-08,mystic river,30000000,90135191,156822020,126822020,True
1856,57,2015-12-18,sisters,30000000,87044645,106030660,76030660,True
1857,58,1999-11-10,pokemon: the first movie,30000000,85744662,163644662,133644662,True
1858,59,2004-11-19,spongebob squarepants: the movie,30000000,85416609,142051255,112051255,True
1859,60,2009-12-04,up in the air,30000000,83823381,166842739,136842739,True
1860,61,2004-06-25,the notebook,30000000,81001787,116025023,86025023,True
1861,62,2009-04-10,hannah montana the movie,30000000,79576189,169173206,139173206,True
1862,63,2008-01-18,27 dresses,30000000,76808654,160247805,130247805,True
1863,64,2000-11-17,rugrats in paris,30000000,76501438,103284813,73284813,True
1864,65,2017-08-18,the hitmanâs bodyguard,30000000,75468583,172778667,142778667,True
1865,66,1991-12-25,the prince of tides,30000000,74787599,74787599,44787599,True
1866,67,2005-08-12,four brothers,30000000,74494381,92494381,62494381,True
1867,68,1994-12-23,legends of the fall,30000000,66502573,160502573,130502573,True
1868,69,2012-09-28,looper,30000000,66486205,170466405,140466405,True
1869,70,2013-02-01,warm bodies,30000000,66380662,115121608,85121608,True
1870,71,2002-12-13,about schmidt,30000000,65005217,107054484,77054484,True
1871,72,2014-01-17,the nut job,30000000,64251538,122529966,92529966,True
1872,73,2001-02-16,down to earth,30000000,64172251,71172251,41172251,True
1873,74,1995-08-04,babe,30000000,63658910,246100000,216100000,True
1874,75,2012-08-08,hope springs,30000000,63536011,133085295,103085295,True
1875,76,2008-04-18,forgetting sarah marshall,30000000,63172463,105173042,75173042,True
1876,77,2004-10-08,friday night lights,30000000,61255921,61950770,31950770,True
1877,78,1989-11-17,harlem nights,30000000,60857262,95857262,65857262,True
1878,79,2008-04-25,baby mama,30000000,60494212,64170447,34170447,True
1879,80,1998-05-29,hope floats,30000000,60110313,81529000,51529000,True
1880,81,2009-01-09,bride wars,30000000,58715510,115150424,85150424,True
1881,82,2004-08-20,without a paddle,30000000,58156435,65121280,35121280,True
1882,83,2011-05-20,midnight in paris,30000000,56816662,162502774,132502774,True
1883,84,2017-11-22,darkest hour,30000000,56443120,150807172,120807172,True
1884,85,2005-10-05,wallace & gromit: the curse of the were-rabbit,30000000,56068547,197593152,167593152,True
1885,86,2007-12-21,p.s. i love you,30000000,53695808,155769678,125769678,True
1886,87,2005-09-23,corpse bride,30000000,53359111,114770654,84770654,True
1887,88,2018-05-11,life of the party,30000000,53059911,65759911,35759911,True
1888,89,2010-05-14,letters to juliet,30000000,53032453,82148538,52148538,True
1889,90,2001-04-06,blow,30000000,52990775,83282296,53282296,True
1890,91,1999-02-12,message in a bottle,30000000,52880016,52880016,22880016,True
1891,92,2015-07-24,southpaw,30000000,52421953,94156456,64156456,True
1892,93,1989-06-09,star trek v: the final frontier,30000000,52210049,70200000,40200000,True
1893,94,2017-07-28,atomic blonde,30000000,51573925,98345423,68345423,True
1894,95,2002-07-03,like mike,30000000,51432423,62432423,32432423,True
1895,96,1994-03-18,naked gun 33 1/3: the final insult,30000000,51041856,51041856,21041856,True
1896,97,2007-12-07,atonement,30000000,50980159,129779728,99779728,True
1897,98,1985-05-24,a view to a kill,30000000,50327960,152627960,122627960,True
1898,99,2005-01-14,racing stripes,30000000,49772522,89955540,59955540,True
1899,100,2015-09-18,sicario,30000000,46889293,84393749,54393749,True
1900,1,1989-09-22,black rain,30000000,45892212,45892212,15892212,True
1901,2,1987-06-26,full metal jacket,30000000,45015999,45015999,15015999,True
1902,3,2018-01-19,den of thieves,30000000,44947622,80131391,50131391,True
1903,4,2012-04-13,the three stooges,30000000,44338224,54052249,24052249,True
1904,5,2000-07-21,pokemon 2000,30000000,43746923,133946923,103946923,True
1905,6,2014-10-24,john wick,30000000,43037835,76235001,46235001,True
1906,7,2006-01-13,glory road,30000000,42647449,42799060,12799060,True
1907,8,2015-04-24,the age of adaline,30000000,42629776,68984536,38984536,True
1908,9,2010-08-06,step up 3d,30000000,42400223,165889117,135889117,True
1909,10,2009-05-29,drag me to hell,30000000,42100625,91388487,61388487,True
1910,11,2012-04-13,the cabin in the woods,30000000,42073277,70689968,40689968,True
1911,12,2003-09-19,secondhand lions,30000000,42070939,47902566,17902566,True
1912,13,2006-11-10,stranger than fiction,30000000,40435190,53572822,23572822,True
1913,14,2011-04-08,hanna,30000000,40259119,65343694,35343694,True
1914,15,2002-08-16,blue crush,30000000,40118420,51618420,21618420,True
1915,16,2007-10-19,30 days of night,30000000,39568996,80276156,50276156,True
1916,17,1986-12-19,little shop of horrors,30000000,38747385,38747385,8747385,True
1917,18,2006-09-15,gridiron gang,30000000,38432823,41457834,11457834,True
1918,19,1988-07-20,midnight run,30000000,38413606,81613606,51613606,True
1919,20,2008-01-25,meet the spartans,30000000,38233676,84646831,54646831,True
1920,21,1987-11-13,the running man,30000000,38122000,38122000,8122000,True
1921,22,2013-09-13,the family,30000000,36918811,51078541,21078541,True
1922,23,2018-02-09,the 15:17 to paris,30000000,36276286,56096200,26096200,True
1923,24,1997-11-21,mortal kombat: annihilation,30000000,35927406,51327406,21327406,True
1924,25,2011-07-01,larry crowne,30000000,35608245,61449135,31449135,True
1925,26,2013-10-18,carrie,30000000,35266619,82409520,52409520,True
1926,27,2006-04-07,take the lead,30000000,34742066,65390493,35390493,True
1927,28,2018-03-02,death wish,30000000,34017028,48575965,18575965,True
1928,29,2010-11-24,love and other drugs,30000000,32367005,102716321,72716321,True
1929,30,2015-06-03,entourage,30000000,32363404,46438538,16438538,True
1930,31,2001-06-01,what's the worst that could happen?,30000000,32267774,38462071,8462071,True
1931,32,2013-02-08,side effects,30000000,32172757,66742138,36742138,True
1932,33,2009-09-09,9,30000000,31749894,48559999,18559999,True
1933,34,2014-07-02,deliver us from evil,30000000,30577122,87956618,57956618,True
1934,35,2014-08-01,get on up,30000000,30569935,33339868,3339868,True
1935,36,2017-12-25,mollyâs game,30000000,28780744,53296424,23296424,False
1936,37,2012-04-27,the five-year engagement,30000000,28700285,61623819,31623819,False
1937,38,2004-04-02,the prince & me,30000000,28165882,29356757,-643243,False
1938,39,2011-07-15,winnie the pooh,30000000,26692846,50145607,20145607,False
1939,40,1998-05-15,bulworth,30000000,26528684,29203383,-796617,False
1940,41,2003-06-13,dumb and dumberer: when harry met lloyd,30000000,26214846,26214846,-3785154,False
1941,42,2018-09-14,white boy rick,30000000,24004833,25947983,-4052017,False
1942,43,1995-08-04,virtuosity,30000000,23998226,23998226,-6001774,False
1943,44,1998-09-18,one true thing,30000000,23337196,26708196,-3291804,False
1944,45,2011-02-04,sanctum,30000000,23209310,108957098,78957098,False
1945,46,2006-07-21,my super ex-girlfriend,30000000,22530295,60772856,30772856,False
1946,47,2017-08-25,ballerina,30000000,21858070,96892829,66892829,False
1947,48,2004-09-17,mr. 3000,30000000,21800302,21827296,-8172704,False
1948,49,2010-11-19,the next three days,30000000,21148651,67255916,37255916,False
1949,50,2018-01-12,proud mary,30000000,20868638,21709539,-8290461,False
1950,51,2004-08-06,little black book,30000000,20422207,21758371,-8241629,False
1951,52,2005-01-19,assault on precinct 13,30000000,20040895,36040895,6040895,False
1952,53,2013-10-04,runner runner,30000000,19316646,60512680,30512680,False
1953,54,1998-02-06,the replacement killers,30000000,19035741,19035741,-10964259,False
1954,55,2017-04-28,baahubali 2: the conclusion,30000000,18985794,263502914,233502914,False
1955,56,2006-03-03,ultraviolet,30000000,18522064,30962112,962112,False
1956,57,2005-10-21,north country,30000000,18324242,23676771,-6323229,False
1957,58,2011-08-19,fright night,30000000,18298649,40520649,10520649,False
1958,59,2017-09-15,mother!,30000000,17800004,42531076,12531076,False
1959,60,2015-10-09,steve jobs,30000000,17766658,35579007,5579007,False
1960,61,2002-07-17,eight legged freaks,30000000,17266505,36722311,6722311,False
1961,62,1996-07-19,fled,30000000,17192205,19892205,-10107795,False
1962,63,2010-06-04,splice,30000000,17010170,28542494,-1457506,False
1963,64,2008-04-18,88 minutes,30000000,16930884,32955399,2955399,False
1964,65,2004-04-09,the whole ten yards,30000000,16323969,26323969,-3676031,False
1965,66,1986-08-01,howard the duck,30000000,16295774,16295774,-13704226,False
1966,67,2008-10-24,pride and glory,30000000,15740721,43440721,13440721,False
1967,68,2005-08-26,the cave,30000000,15007991,27147991,-2852009,False
1968,69,2004-04-30,godsend,30000000,14334645,16910708,-13089292,False
1969,70,2003-06-20,alex & emma,30000000,14208384,15358583,-14641417,False
1970,71,2004-09-03,wicker park,30000000,13001257,21577076,-8422924,False
1971,72,2005-12-25,the new world,30000000,12712093,26184400,-3815600,False
1972,73,2007-06-29,evening,30000000,12406646,12885574,-17114426,False
1973,74,2013-01-18,the last stand,30000000,12050299,48330757,18330757,False
1974,75,1999-01-15,in dreams,30000000,12017369,12017369,-17982631,False
1975,76,1999-03-12,wing commander,30000000,11578022,11578022,-18421978,False
1976,77,2001-01-12,antitrust,30000000,10965209,17865209,-12134791,False
1977,78,2013-03-08,dead man down,30000000,10895295,19599974,-10400026,False
1978,79,2011-04-29,hoodwinked too: hood vs. evil,30000000,10143779,23353111,-6646889,False
1979,80,2009-04-10,dragonball evolution,30000000,9362785,58228460,28228460,False
1980,81,2004-09-24,first daughter,30000000,9055010,10419084,-19580916,False
1981,82,2017-04-14,the lost city of z,30000000,8574339,17121823,-12878177,False
1982,83,2005-09-09,an unfinished life,30000000,8535575,18535575,-11464425,False
1983,84,2017-02-03,the space between us,30000000,7885294,16481405,-13518595,False
1984,85,2009-12-25,the imaginarium of doctor parnassus,30000000,7689607,64352607,34352607,False
1985,86,2011-01-14,barney's version,30000000,7502560,8845575,-21154425,False
1986,87,2002-09-20,trapped,30000000,6916869,6916869,-23083131,False
1987,88,2018-08-31,kin,30000000,5718096,10096821,-19903179,False
1988,89,1984-06-01,once upon a time in america,30000000,5321508,5575648,-24424352,False
1989,90,2017-09-22,stronger,30000000,4211129,8786752,-21213248,False
1990,91,1999-01-22,gloria,30000000,4167493,4967493,-25032507,False
1991,92,2007-09-21,the assassination of jesse james by the coward robert ford,30000000,3909149,15313631,-14686369,False
1992,93,2004-12-29,the merchant of venice,30000000,3765585,18765585,-11234415,False
1993,94,2003-04-02,the good thief,30000000,3517797,6460758,-23539242,False
1994,95,2005-08-17,supercross,30000000,3102550,3252550,-26747450,False
1995,96,2006-12-29,miss potter,30000000,3005605,35891257,5891257,False
1996,97,2006-05-05,wu ji,30000000,669625,35869934,5869934,False
1997,98,2019-06-14,shaft,30000000,600000,600000,-29400000,False
1998,99,2011-09-23,machine gun preacher,30000000,538690,3721988,-26278012,False
1999,100,2018-02-02,bilal: a new breed of hero,30000000,490973,648599,-29351401,False
2000,1,2007-06-15,doa: dead or alive,30000000,480314,7755686,-22244314,False
2001,2,2010-02-19,le petit nicolas,30000000,201857,52339566,22339566,False
2002,3,2011-10-07,xinhai geming,30000000,135739,8593154,-21406846,False
2003,4,2008-02-21,genghis khan: to the ends of the earth and sea,30000000,3892,4874498,-25125502,False
2004,5,2015-01-30,wild card,30000000,3200,4315789,-25684211,False
2005,6,2015-06-05,united passions,30000000,918,168832,-29831168,False
2006,7,2010-12-31,konferenz der tiere,30000000,0,53048539,23048539,False
2007,8,2015-12-01,grace of monaco,30000000,0,25199891,-4800109,False
2008,9,2016-03-08,savva. serdtse voyna,30000000,0,5015080,-24984920,False
2009,10,2007-12-14,goodbye bafana,30000000,0,2717302,-27282698,False
2010,11,2013-12-31,space pirate captain harlock,30000000,0,310985,-29689015,False
2011,12,2003-12-31,ripley's game,30000000,0,0,-30000000,False
2012,13,2017-02-24,collide,29200000,2280004,5466698,-23733302,False
2013,14,2015-05-15,pitch perfect 2,29000000,184296230,287625468,258625468,True
2014,15,2005-11-18,walk the line,29000000,119519402,187707495,158707495,True
2015,16,2018-09-28,night school,29000000,77339130,103008792,74008792,True
2016,17,2016-04-08,the boss,29000000,63077560,78652207,49652207,True
2017,18,1995-12-27,12 monkeys,29000000,57141459,168841459,139841459,True
2018,19,2003-09-12,once upon a time in mexico,29000000,56330657,97413527,68413527,True
2019,20,2000-04-14,keeping the faith,29000000,37036404,45336404,16336404,True
2020,21,2017-08-18,logan lucky,29000000,27778642,44264271,15264271,False
2021,22,2016-08-12,florence foster jenkins,29000000,27383770,56000339,27000339,False
2022,23,1998-02-13,the borrowers,29000000,22619589,54045832,25045832,False
2023,24,2008-12-05,frost/nixon,29000000,18622031,28452945,-547055,False
2024,25,2004-11-12,seed of chucky,29000000,17016190,24716190,-4283810,False
2025,26,2002-08-23,serving sara,29000000,16930185,20146150,-8853850,False
2026,27,2002-12-31,confessions of a dangerous mind,29000000,16007718,33013805,4013805,False
2027,28,2009-08-26,taking woodstock,29000000,7460204,10066366,-18933634,False
2028,29,1987-11-06,cry freedom,29000000,5899797,25899797,-3100203,False
2029,30,2019-09-30,unhinged,29000000,0,0,-29000000,False
2030,31,1999-09-24,mumford,28700000,4559569,4559569,-24140431,False
2031,32,2005-03-04,the jacket,28500000,6301131,15452978,-13047022,False
2032,33,1992-11-11,aladdin,28000000,217350219,504050219,476050219,True
2033,34,1984-05-23,indiana jones and the temple of doom,28000000,179880271,333080271,305080271,True
2034,35,2015-08-14,straight outta compton,28000000,161197785,202182981,174182981,True
2035,36,2017-07-21,girls trip,28000000,115108515,140886353,112886353,True
2036,37,1998-11-20,the rugrats movie,28000000,100494685,140894685,112894685,True
2037,38,1988-07-15,die hard,28000000,81350242,139109346,111109346,True
2038,39,2001-04-06,along came a spider,28000000,74058698,105159085,77159085,True
2039,40,2017-11-01,a bad moms christmas,28000000,72110659,127710550,99710550,True
2040,41,2013-02-14,safe haven,28000000,71399120,94050951,66050951,True
2041,42,2015-12-11,the big short,28000000,70259870,133162752,105162752,True
2042,43,2008-11-07,role models,28000000,67300955,94500826,66500826,True
2043,44,2014-10-10,"alexander and the terrible, horrible, no good, very bad day",28000000,66954149,101379287,73379287,True
2044,45,2004-02-06,miracle,28000000,64378093,64474705,36474705,True
2045,46,2013-01-28,last vegas,28000000,63914167,112914167,84914167,True
2046,47,2001-01-26,the wedding planner,28000000,60400856,94728529,66728529,True
2047,48,2004-03-19,dawn of the dead,28000000,58990765,103452875,75452875,True
2048,49,1981-06-26,for your eyes only,28000000,54800000,195300000,167300000,True
2049,50,2018-06-15,tag,28000000,54730625,77026186,49026186,True
2050,51,2001-12-14,the royal tenenbaums,28000000,52353636,71430876,43430876,True
2051,52,2003-04-25,identity,28000000,52131264,82183683,54183683,True
2052,53,2001-10-05,serendipity,28000000,50255310,77477297,49477297,True
2053,54,2010-04-16,kick-ass,28000000,48071303,97531134,69531134,True
2054,55,2001-09-28,zoolander,28000000,45172250,60780981,32780981,True
2055,56,1994-09-16,timecop,28000000,44853581,102053581,74053581,True
2056,57,2007-07-27,no reservations,28000000,43107979,91943956,63943956,True
2057,58,1993-07-16,hocus pocus,28000000,39360491,39360491,11360491,True
2058,59,2005-11-11,pride & prejudice,28000000,38372662,126549607,98549607,True
2059,60,2011-08-12,30 minutes or less,28000000,37053924,40966716,12966716,True
2060,61,2000-12-22,dracula 2000,28000000,33000377,33000377,5000377,True
2061,62,1982-06-25,blade runner,28000000,32656328,39342912,11342912,True
2062,63,1995-04-07,rob roy,28000000,31390587,31390587,3390587,True
2063,64,2014-02-21,3 days to kill,28000000,30697999,38959900,10959900,True
2064,65,2013-08-16,kick-ass 2,28000000,28795985,63129909,35129909,True
2065,66,2007-10-12,we own the night,28000000,28563179,55307857,27307857,True
2066,67,2014-09-19,a walk among the tombstones,28000000,26017685,62108587,34108587,False
2067,68,2010-01-15,the spy next door,28000000,24307106,46752858,18752858,False
2068,69,2014-04-25,brick mansions,28000000,20396829,73421224,45421224,False
2069,70,2006-05-12,just my luck,28000000,17326650,38159905,10159905,False
2070,71,2000-10-13,lost souls,28000000,16779636,31320293,3320293,False
2071,72,2015-08-21,american ultra,28000000,14439985,30295028,2295028,False
2072,73,2003-04-18,winged migration,28000000,11689053,39134983,11134983,False
2073,74,2016-02-05,pride and prejudice and zombies,28000000,10907291,16638300,-11361700,False
2074,75,1999-10-01,"mystery, alaska",28000000,8891623,8891623,-19108377,False
2075,76,2001-08-24,john carpenterâs ghosts of mars,28000000,8434601,8434601,-19565399,False
2076,77,1997-07-11,a simple wish,28000000,8165213,8165213,-19834787,False
2077,78,2015-10-30,our brand is crisis,28000000,7002261,8594558,-19405442,False
2078,79,1997-12-25,kundun,28000000,5686694,5686694,-22313306,False
2079,80,2008-10-03,how to lose friends & alienate people,28000000,2775593,12031443,-15968557,False
2080,81,2007-12-31,alatriste,28000000,0,22860477,-5139523,False
2081,82,2007-06-01,knocked up,27500000,148761765,219265952,191765952,True
2082,83,1983-06-10,octopussy,27500000,67900000,187500000,160000000,True
2083,84,2009-06-26,my sister's keeper,27500000,49200230,96673002,69173002,True
2084,85,2008-02-08,welcome home roscoe jenkins,27500000,42436517,43607627,16107627,True
2085,86,2012-01-13,joyful noise,27500000,30932113,31157914,3657914,True
2086,87,1984-12-14,a passage to india,27500000,27187653,27187653,-312347,False
2087,88,2006-12-25,notes on a scandal,27500000,17510118,50578411,23078411,False
2088,89,2007-10-19,rendition,27500000,9736045,26939925,-560075,False
2089,90,2011-10-28,anonymous,27500000,4463292,15815509,-11684491,False
2090,91,2011-03-18,limitless,27000000,79249455,155564919,128564919,True
2091,92,1991-12-06,star trek vi: the undiscovered country,27000000,74888996,96900000,69900000,True
2092,93,2002-06-07,the divine secrets of the ya-ya sisterhood,27000000,69586544,73826768,46826768,True
2093,94,1997-10-03,kiss the girls,27000000,60527873,60527873,33527873,True
2094,95,1980-06-20,the blues brothers,27000000,57229890,57229890,30229890,True
2095,96,1994-12-25,the jungle book,27000000,44342956,44342956,17342956,True
2096,97,2008-08-06,the sisterhood of the traveling pants 2,27000000,44089964,44270131,17270131,True
2097,98,2016-05-13,money monster,27000000,41012075,93466095,66466095,True
2098,99,2002-05-17,about a boy,27000000,40803000,130759651,103759651,True
2099,100,2011-08-19,spy kids: all the time in the world,27000000,38536376,80681183,53681183,True
2100,1,1999-07-16,lake placid,27000000,31770413,31770413,4770413,True
2101,2,2006-04-07,lucky number slevin,27000000,22495466,55495466,28495466,False
2102,3,1983-10-21,the right stuff,27000000,21500000,21500000,-5500000,False
2103,4,1984-07-20,die unendliche geschichte,27000000,21300000,21392049,-5607951,False
2104,5,1998-02-27,dark city,27000000,14435076,27257061,257061,False
2105,6,2008-09-19,the duchess,27000000,13848978,45160110,18160110,False
2106,7,2010-10-01,case 39,27000000,13261851,28773827,1773827,False
2107,8,2005-06-10,the honeymooners,27000000,12834849,13174426,-13825574,False
2108,9,1985-06-21,return to oz,27000000,10618813,10618813,-16381187,False
2109,10,1998-03-27,the newton boys,27000000,10341093,10341093,-16658907,False
2110,11,2004-08-27,suspect zero,27000000,8712564,8712564,-18287436,False
2111,12,2007-11-02,martian child,27000000,7500310,9352089,-17647911,False
2112,13,2002-10-18,formula 51,27000000,5204007,5204007,-21795993,False
2113,14,1999-11-24,flawless,27000000,4485485,4485485,-22514515,False
2114,15,2005-05-13,mindhunters,27000000,4476235,16566235,-10433765,False
2115,16,2008-10-17,what just happened,27000000,1090947,2412123,-24587877,False
2116,17,2003-12-12,the statement,27000000,765637,1545064,-25454936,False
2117,18,2006-12-31,the magic flute,27000000,0,0,-27000000,False
2118,19,2016-11-23,rules donât apply,26700000,3652206,3871448,-22828552,False
2119,20,2009-01-16,paul blart: mall cop,26000000,146336178,185904750,159904750,True
2120,21,2003-08-06,freaky friday,26000000,110222438,160822438,134822438,True
2121,22,2005-08-19,the 40 year-old virgin,26000000,109449237,177344230,151344230,True
2122,23,1998-12-11,shakespeare in love,26000000,100317794,279500000,253500000,True
2123,24,1990-12-21,kindergarten cop,26000000,91457688,202000000,176000000,True
2124,25,2008-08-06,pineapple express,26000000,87341380,102404019,76404019,True
2125,26,1993-12-22,philadelphia,26000000,77324422,201324422,175324422,True
2126,27,1998-07-31,ever after: a cinderella story,26000000,65705772,65705772,39705772,True
2127,28,1990-08-10,flatliners,26000000,61308153,61308153,35308153,True
2128,29,2003-08-15,open range,26000000,58331254,68613992,42613992,True
2129,30,2005-08-19,red eye,26000000,57891803,96666486,70666486,True
2130,31,2011-12-09,new yearâs eve,26000000,54544638,146850273,120850273,True
2131,32,1977-06-15,a bridge too far,26000000,50800000,50800000,24800000,True
2132,33,2013-04-26,pain & gain,26000000,49875291,81275291,55275291,True
2133,34,2003-01-31,final destination 2,26000000,46896664,90396664,64396664,True
2134,35,2000-12-22,"o brother, where art thou?",26000000,45506619,75763814,49763814,True
2135,36,2004-12-29,in good company,26000000,45489752,63489752,37489752,True
2136,37,2010-01-22,legion,26000000,40168080,67647574,41647574,True
2137,38,2012-08-29,lawless,26000000,37397291,54393687,28393687,True
2138,39,2002-03-29,clockstoppers,26000000,36985501,38788828,12788828,True
2139,40,1985-07-10,silverado,26000000,33200000,33200000,7200000,True
2140,41,2009-12-04,brothers,26000000,28544157,45043870,19043870,True
2141,42,2014-10-17,the best of me,26000000,26766213,41059418,15059418,True
2142,43,2004-03-12,agent cody banks 2: destination london,26000000,23514247,28703083,2703083,False
2143,44,2001-08-03,original sin,26000000,16521410,16521410,-9478590,False
2144,45,2012-04-27,the raven,26000000,16008272,30601801,4601801,False
2145,46,2004-02-20,welcome to mooseport,26000000,14469428,14469428,-11530572,False
2146,47,1995-01-27,highlander: the final dimension,26000000,13738574,13738574,-12261426,False
2147,48,2015-07-10,self/less,26000000,12279691,33667319,7667319,False
2148,49,2001-08-24,the curse of the jade scorpion,26000000,7496522,18496522,-7503478,False
2149,50,2013-10-18,the fifth estate,26000000,3254172,6154172,-19845828,False
2150,51,1997-02-21,blood and wine,26000000,1083350,1083350,-24916650,False
2151,52,2014-03-21,blood ties,26000000,42472,2923959,-23076041,False
2152,53,1997-08-24,the grimm brothers' snow white,26000000,5000,5000,-25995000,False
2153,54,2015-06-30,viy,26000000,0,34246770,8246770,False
2154,55,2015-03-17,accidental love,26000000,0,135436,-25864564,False
2155,56,2015-04-24,the face of an angel,26000000,0,0,-26000000,False
2156,57,1996-05-17,flipper,25530000,20080020,30593313,5063313,False
2157,58,2005-08-31,the constant gardener,25500000,33579798,86301599,60801599,True
2158,59,2008-10-17,w.,25100000,25534493,28575778,3475778,True
2159,60,2004-02-25,the passion of the christ,25000000,370782930,622341924,597341924,True
2160,61,1993-11-24,mrs. doubtfire,25000000,219195051,441286003,416286003,True
2161,62,1988-12-16,rain man,25000000,172825435,412800000,387800000,True
2162,63,2011-08-10,the help,25000000,169705587,213120004,188120004,True
2163,64,2016-12-25,hidden figures,25000000,169607287,231771716,206771716,True
2164,65,2008-12-12,gran torino,25000000,148095302,274543085,249543085,True
2165,66,2009-01-30,taken,25000000,145000989,226941585,201941585,True
2166,67,2014-01-17,ride along,25000000,134202565,153733800,128733800,True
2167,68,1992-11-25,the bodyguard,25000000,121945720,410899039,385899039,True
2168,69,1993-12-15,schindlerâs list,25000000,96898818,322197132,297197132,True
2169,70,2003-07-02,"legally blonde 2: red, white & blonde",25000000,90639088,125339088,100339088,True
2170,71,2004-03-26,scooby-doo 2: monsters unleashed,25000000,84185387,181185387,156185387,True
2171,72,2004-07-09,anchorman: the legend of ron burgundy,25000000,84136909,89476265,64476265,True
2172,73,2003-08-15,freddy vs. jason,25000000,82622655,114576403,89576403,True
2173,74,2007-02-16,bridge to terabithia,25000000,82234139,137984788,112984788,True
2174,75,2001-12-21,jimmy neutron: boy genius,25000000,80936232,102992536,77992536,True
2175,76,2008-01-18,cloverfield,25000000,80048433,171302226,146302226,True
2176,77,2010-02-05,dear john,25000000,80014842,142033509,117033509,True
2177,78,1991-03-22,teenage mutant ninja turtles ii: the secret of the ooze,25000000,78656813,78656813,53656813,True
2178,79,2012-12-25,parental guidance,25000000,77267296,120832383,95832383,True
2179,80,1987-06-03,the untouchables,25000000,76270454,76270454,51270454,True
2180,81,2007-11-09,no country for old men,25000000,74273505,164035753,139035753,True
2181,82,2001-04-13,bridget jones's diary,25000000,71500556,281527158,256527158,True
2182,83,2000-12-15,chocolat,25000000,71309760,152500343,127500343,True
2183,84,2011-01-21,no strings attached,25000000,70662220,149228078,124228078,True
2184,85,2012-01-13,contraband,25000000,66528000,98406855,73406855,True
2185,86,2017-01-27,a dogâs purpose,25000000,64321890,203671625,178671625,True
2186,87,2012-04-20,the lucky one,25000000,60457138,96633833,71633833,True
2187,88,1993-12-25,tombstone,25000000,56505065,56505065,31505065,True
2188,89,2000-03-22,romeo must die,25000000,55973336,91036760,66036760,True
2189,90,2006-06-06,the omen,25000000,54607383,119295584,94295584,True
2190,91,2006-02-10,final destination 3,25000000,54098051,112798051,87798051,True
2191,92,2011-04-22,madea's big happy family,25000000,53345287,54160818,29160818,True
2192,93,2013-12-13,tyler perry's a madea christmas,25000000,52543354,52543354,27543354,True
2193,94,2004-11-12,finding neverland,25000000,51676606,115036108,90036108,True
2194,95,2012-01-27,the grey,25000000,51580136,81249176,56249176,True
2195,96,2005-01-28,hide and seek,25000000,51100486,123696741,98696741,True
2196,97,1986-05-23,cobra,25000000,49042224,49042224,24042224,True
2197,98,2008-08-22,the house bunny,25000000,48237389,71390601,46390601,True
2198,99,2003-03-14,agent cody banks,25000000,47545060,58240458,33240458,True
2199,100,2006-01-27,nanny mcphee,25000000,47279279,128745578,103745578,True
2200,1,1990-09-19,goodfellas,25000000,46743809,46777347,21777347,True
2201,2,2014-08-15,the giver,25000000,45090374,66540205,41540205,True
2202,3,1983-12-09,scarface,25000000,44942821,44942821,19942821,True
2203,4,1997-07-18,nothing to lose,25000000,44480039,64594061,39594061,True
2204,5,1987-11-20,the last emperor,25000000,43984987,44005073,19005073,True
2205,6,2015-11-20,the night before,25000000,43035725,52427346,27427346,True
2206,7,1993-10-15,the beverly hillbillies,25000000,42222647,55598481,30598481,True
2207,8,2002-12-27,the hours,25000000,41675994,97030468,72030468,True
2208,9,1997-08-22,money talks,25000000,41076865,41076865,16076865,True
2209,10,2007-12-26,there will be blood,25000000,40222514,77208711,52208711,True
2210,11,2002-12-20,the wild thornberrys movie,25000000,40108697,60694737,35694737,True
2211,12,2003-06-13,rugrats go wild,25000000,39402572,55443032,30443032,True
2212,13,2005-06-01,the sisterhood of the traveling pants,25000000,39053061,41560117,16560117,True
2213,14,2002-05-31,undercover brother,25000000,38230435,40796145,15796145,True
2214,15,2013-12-25,august: osage county,25000000,37738810,50738810,25738810,True
2215,16,2001-07-06,kiss of the dragon,25000000,36833473,36833473,11833473,True
2216,17,2014-05-16,million dollar arm,25000000,36447959,39217912,14217912,True
2217,18,2004-01-01,beauty shop,25000000,36351350,38351350,13351350,True
2218,19,2003-04-04,what a girl wants,25000000,35990505,35990505,10990505,True
2219,20,2003-08-29,jeepers creepers ii,25000000,35623801,119923801,94923801,True
2220,21,2018-09-07,peppermint,25000000,35418723,51800758,26800758,True
2221,22,2007-09-21,good luck chuck,25000000,35017297,59183821,34183821,True
2222,23,2003-02-28,cradle 2 the grave,25000000,34657731,56434942,31434942,True
2223,24,2006-03-17,she's the man,25000000,33889159,55279608,30279608,True
2224,25,2014-12-10,the gambler,25000000,33680992,38718031,13718031,True
2225,26,2007-08-24,mr. beanâs holiday,25000000,33302167,234981342,209981342,True
2226,27,2016-04-29,motherâs day,25000000,32492859,52367022,27367022,True
2227,28,1998-10-16,bride of chucky,25000000,32404188,50692188,25692188,True
2228,29,2017-02-17,fist fight,25000000,32187017,40286416,15286416,True
2229,30,2007-11-21,august rush,25000000,31664162,65882103,40882103,True
2230,31,2004-08-27,anacondas: the hunt for the blood orchid,25000000,31526393,70326393,45326393,True
2231,32,2011-12-09,the sitter,25000000,30542576,38749404,13749404,True
2232,33,1998-11-06,elizabeth,25000000,30082699,82150642,57150642,True
2233,34,1970-09-23,"tora, tora, tora",25000000,29548291,29548291,4548291,True
2234,35,1998-01-23,spice world,25000000,29342592,56042592,31042592,True
2235,36,2014-04-11,draft day,25000000,28842237,29847480,4847480,True
2236,37,1994-09-23,the shawshank redemption,25000000,28241469,28307092,3307092,True
2237,38,2017-02-03,rings,25000000,27793018,82917283,57917283,True
2238,39,2009-05-22,dance flick,25000000,25794018,32224624,7224624,True
2239,40,2001-04-20,crocodile dundee in los angeles,25000000,25590119,39393111,14393111,True
2240,41,1996-07-26,kingpin,25000000,25023424,32223424,7223424,True
2241,42,2005-03-18,ice princess,25000000,24381334,25732334,732334,False
2242,43,2011-08-26,don't be afraid of the dark,25000000,24046682,39126427,14126427,False
2243,44,2010-04-23,the losers,25000000,23591432,29863840,4863840,False
2244,45,2009-04-24,fighting,25000000,23091010,32831707,7831707,False
2245,46,2007-08-24,war,25000000,22486409,40686409,15686409,False
2246,47,1995-04-07,don juan demarco,25000000,22032635,22032635,-2967365,False
2247,48,2005-04-22,a lot like love,25000000,21835784,41921590,16921590,False
2248,49,1998-05-01,he got game,25000000,21567853,22411948,-2588052,False
2249,50,2011-02-11,the eagle,25000000,19490041,38993548,13993548,False
2250,51,2015-08-05,shaun the sheep,25000000,19375982,101925161,76925161,False
2251,52,2011-09-02,shark night 3d,25000000,18877153,18877153,-6122847,False
2252,53,2017-03-24,chips,25000000,18600152,23190292,-1809708,False
2253,54,2002-10-11,punch-drunk love,25000000,17791031,24591031,-408969,False
2254,55,2004-02-20,eurotrip,25000000,17718223,20718223,-4281777,False
2255,56,2017-12-22,father figures,25000000,17501244,21038441,-3961559,False
2256,57,2008-04-04,the ruins,25000000,17432844,22910563,-2089437,False
2257,58,2013-10-25,the counselor,25000000,16973715,71009334,46009334,False
2258,59,2006-12-08,unaccompanied minors,25000000,16655224,21970831,-3029169,False
2259,60,2018-12-07,mary queen of scots,25000000,16468499,46734733,21734733,False
2260,61,1988-04-01,"bright lights, big city",25000000,16118077,16118077,-8881923,False
2261,62,2002-11-15,half past dead,25000000,15567860,19233280,-5766720,False
2262,63,1986-04-18,legend,25000000,15502112,23506237,-1493763,False
2263,64,1996-07-26,the adventures of pinocchio,25000000,15382170,36682170,11682170,False
2264,65,2005-09-30,the greatest game ever played,25000000,15331289,15468266,-9531734,False
2265,66,2009-11-06,the box,25000000,15051977,34356760,9356760,False
2266,67,2000-03-03,the next best thing,25000000,14983572,24355762,-644238,False
2267,68,2010-10-08,my soul to take,25000000,14744435,16727470,-8272530,False
2268,69,2004-04-09,the girl next door,25000000,14589444,31635150,6635150,False
2269,70,2008-08-15,fly me to the moon,25000000,14543943,43530281,18530281,False
2270,71,1996-09-13,maximum risk,25000000,14102929,51702929,26702929,False
2271,72,2002-09-13,stealing harvard,25000000,13973532,13973532,-11026468,False
2272,73,2007-08-03,hot rod,25000000,13938332,14334401,-10665599,False
2273,74,2011-09-09,warrior,25000000,13657115,24215385,-784615,False
2274,75,1999-12-24,angela's ashes,25000000,13038660,13038660,-11961340,False
2275,76,2017-09-22,battle of the sexes,25000000,12638526,18445379,-6554621,False
2276,77,2012-12-21,cirque du soleil: worlds away,25000000,12512862,28012862,3012862,False
2277,78,2015-11-13,the 33,25000000,12227722,28400715,3400715,False
2278,79,1985-06-21,lifeforce,25000000,11603545,11603545,-13396455,False
2279,80,2011-04-15,the conspirator,25000000,11538204,15907411,-9092589,False
2280,81,2002-07-03,the powerpuff girls,25000000,11411644,16425701,-8574299,False
2281,82,2005-06-03,the lords of dogtown,25000000,11273517,13424365,-11575635,False
2282,83,1986-07-01,big trouble in little china,25000000,11100000,11100000,-13900000,False
2283,84,1996-10-11,michael collins,25000000,11092559,27572844,2572844,False
2284,85,2008-03-28,stop-loss,25000000,10915744,11229035,-13770965,False
2285,86,1993-10-08,gettysburg,25000000,10731997,10731997,-14268003,False
2286,87,2002-10-18,abandon,25000000,10719367,12219367,-12780633,False
2287,88,2011-09-16,straw dogs,25000000,10324441,11253821,-13746179,False
2288,89,1999-08-13,brokedown palace,25000000,10115014,11115766,-13884234,False
2289,90,2002-08-16,possession,25000000,10103647,14805812,-10194188,False
2290,91,1996-04-19,mrs. winterbourne,25000000,10039566,10039566,-14960434,False
2291,92,1991-05-17,stone cold,25000000,9286314,9286314,-15713686,False
2292,93,2019-01-25,serenity,25000000,8547045,11367029,-13632971,False
2293,94,2009-11-25,the road,25000000,8114270,29206732,4206732,False
2294,95,2018-10-12,beautiful boy,25000000,7634767,13031424,-11968576,False
2295,96,2007-04-06,the hoax,25000000,7164995,7164995,-17835005,False
2296,97,2019-03-15,captive state,25000000,5958315,8993300,-16006700,False
2297,98,1984-08-17,sheena,25000000,5778353,5778353,-19221647,False
2298,99,2005-09-02,underclassman,25000000,5654777,5654777,-19345223,False
2299,100,2001-03-23,say it isn't so,25000000,5516708,5516708,-19483292,False
2300,1,2005-12-07,the world's fastest indian,25000000,5128124,18991288,-6008712,False
2301,2,2008-04-25,deception,25000000,4598506,12850033,-12149967,False
2302,3,1995-03-01,tank girl,25000000,4064333,4064333,-20935667,False
2303,4,2005-04-22,king's ransom,25000000,4008527,4049527,-20950473,False
2304,5,2008-10-03,blindness,25000000,3073392,20052958,-4947042,False
2305,6,2018-04-13,sgt. stubby: an american hero,25000000,3054285,3645957,-21354043,False
2306,7,2011-12-16,carnage,25000000,2546747,38112154,13112154,False
2307,8,2017-09-01,tulip fever,25000000,2455635,6792768,-18207232,False
2308,9,2006-01-06,bloodrayne,25000000,2405420,3711633,-21288367,False
2309,10,2015-11-20,legend,25000000,1872994,42425450,17425450,False
2310,11,2009-11-20,bad lieutenant: port of call new orleans,25000000,1702112,12413949,-12586051,False
2311,12,2016-01-29,jane got a gun,25000000,1513793,3771345,-21228655,False
2312,13,2009-11-25,me and orson welles,25000000,1190003,1190003,-23809997,False
2313,14,2005-09-16,venom,25000000,881745,881745,-24118255,False
2314,15,2005-10-14,where the truth lies,25000000,872142,1415656,-23584344,False
2315,16,1998-09-11,without limits,25000000,780326,780326,-24219674,False
2316,17,2013-03-22,on the road,25000000,720828,9313302,-15686698,False
2317,18,2012-08-24,les petits mouchoirs,25000000,205505,48530887,23530887,False
2318,19,2010-06-30,love ranch,25000000,137885,146149,-24853851,False
2319,20,2015-04-24,yi ge ren de wu lin,25000000,129115,129115,-24870885,False
2320,21,2010-12-31,sammy's avonturen: de geheime doorgang,25000000,0,71594792,46594792,False
2321,22,2010-12-31,belka i strelka. zvezdnye sobaki,25000000,0,9445081,-15554919,False
2322,23,2017-12-31,matilda,25000000,0,9370285,-15629715,False
2323,24,2011-10-04,la vã©ritable histoire du chat bottã©,25000000,0,8208594,-16791406,False
2324,25,2011-07-08,ironclad,25000000,0,5297411,-19702589,False
2325,26,2019-05-10,the professor and the madman,25000000,0,5227233,-19772767,False
2326,27,2015-03-10,red sky,25000000,0,91116,-24908884,False
2327,28,1970-01-01,waterloo,25000000,0,0,-25000000,False
2328,29,2014-01-10,the adventurer: the curse of the midas box,25000000,0,0,-25000000,False
2329,30,2019-12-31,reagan,25000000,0,0,-25000000,False
2330,31,2012-11-09,dangerous liaisons,24200000,17000,10447579,-13752421,False
2331,32,1986-11-26,star trek iv: the voyage home,24000000,109713132,133000000,109000000,True
2332,33,1997-12-12,scream 2,24000000,101363301,172363301,148363301,True
2333,34,2003-02-21,old school,24000000,75155000,86765463,62765463,True
2334,35,2006-12-20,rocky balboa,24000000,70269899,156229050,132229050,True
2335,36,2014-06-20,think like a man too,24000000,65028687,70027933,46027933,True
2336,37,2016-12-16,fences,24000000,57682904,64282881,40282881,True
2337,38,2000-02-18,the whole nine yards,24000000,57262492,85527867,61527867,True
2338,39,2011-10-14,footloose,24000000,51802742,62989834,38989834,True
2339,40,2017-04-07,going in style,24000000,45018541,78672579,54672579,True
2340,41,1991-07-12,point break,24000000,43218387,83531958,59531958,True
2341,42,1991-09-20,the fisher king,24000000,41798224,41798224,17798224,True
2342,43,1998-11-13,i still know what you did last summer,24000000,40020622,40020622,16020622,True
2343,44,2007-11-21,hitman,24000000,39687694,99135571,75135571,True
2344,45,1969-12-16,"hello, dolly",24000000,33208099,33208099,9208099,True
2345,46,2000-04-07,return to me,24000000,32662299,32662299,8662299,True
2346,47,2009-11-06,the men who stare at goats,24000000,32428195,67348218,43348218,True
2347,48,2008-10-31,zack and miri make a porno,24000000,31457946,36856306,12856306,True
2348,49,2001-01-12,double take,24000000,29823162,29823162,5823162,True
2349,50,1999-12-21,"girl, interrupted",24000000,28871190,28871190,4871190,True
2350,51,2000-09-08,nurse betty,24000000,25170054,27732366,3732366,True
2351,52,2010-08-20,piranha 3d,24000000,25003155,83660160,59660160,True
2352,53,2010-11-24,faster,24000000,23240020,35792945,11792945,False
2353,54,1978-10-24,the wiz,24000000,22000000,22000000,-2000000,False
2354,55,2004-01-23,win a date with tad hamilton!,24000000,16980098,16980098,-7019902,False
2355,56,1999-07-14,muppets from space,24000000,16304786,16304786,-7695214,False
2356,57,2000-04-07,ready to rumble,24000000,12372410,12372410,-11627590,False
2357,58,2011-09-16,i don't know how she does it,24000000,9659074,24474463,474463,False
2358,59,1999-12-24,play it to the bone,24000000,8427204,8427204,-15572796,False
2359,60,2013-12-20,dhoom 3,24000000,8031955,11723620,-12276380,False
2360,61,2004-12-17,beyond the sea,24000000,6144806,8292914,-15707086,False
2361,62,2005-06-10,hauru no ugoku shiro,24000000,4710455,237814327,213814327,False
2362,63,1998-03-27,meet the deedles,24000000,4356126,4356126,-19643874,False
2363,64,1995-08-25,the thief and the cobbler,24000000,669276,669276,-23330724,False
2364,65,2005-06-10,the bridge of san luis rey,24000000,49981,1696765,-22303235,False
2365,66,2007-12-31,flood,24000000,0,4084232,-19915768,False
2366,67,2009-10-02,zombieland,23600000,75590286,102236596,78636596,True
2367,68,1980-05-21,star wars ep. v: the empire strikes back,23000000,290271960,534161334,511161334,True
2368,69,1998-11-06,the waterboy,23000000,161491646,190191646,167191646,True
2369,70,1991-06-28,the naked gun 2â½: the smell of fear,23000000,86930411,86930411,63930411,True
2370,71,2018-11-16,green book,23000000,85080171,322034439,299034439,True
2371,72,1995-04-07,bad boys,23000000,65647413,141247413,118247413,True
2372,73,2015-01-16,the wedding ringer,23000000,64460211,80171596,57171596,True
2373,74,2000-03-17,final destination,23000000,53302314,112036870,89036870,True
2374,75,1976-12-17,king kong,23000000,52614445,90614445,67614445,True
2375,76,2011-10-07,the ides of march,23000000,40962534,77735925,54735925,True
2376,77,2000-02-18,pitch black,23000000,39235088,53182088,30182088,True
2377,78,2018-10-05,the hate u give,23000000,29719483,35067665,12067665,True
2378,79,2001-03-30,someone like you,23000000,27338033,38684906,15684906,True
2379,80,2014-01-10,her,23000000,25568251,48163815,25163815,True
2380,81,2001-10-05,joy ride,23000000,21973182,21973182,-1026818,False
2381,82,2012-02-17,kari gurashi no arietti,23000000,19192510,151496097,128496097,False
2382,83,2012-01-20,haywire,23000000,18942396,36374700,13374700,False
2383,84,1999-11-12,anywhere but here,23000000,18653615,18653615,-4346385,False
2384,85,2004-09-01,vanity fair,23000000,16123851,19123851,-3876149,False
2385,86,2016-02-26,eddie the eagle,23000000,15789389,45060480,22060480,False
2386,87,1987-07-17,jaws 4: the revenge,23000000,15728335,15728335,-7271665,False
2387,88,2000-08-25,the crew,23000000,13019253,13019253,-9980747,False
2388,89,1996-12-20,marvin's room,23000000,12803305,12803305,-10196695,False
2389,90,2004-01-09,chasing liberty,23000000,12189514,12291975,-10708025,False
2390,91,2008-08-22,the longshots,23000000,11511323,11778396,-11221604,False
2391,92,1999-12-03,the end of the affair,23000000,10660147,10660147,-12339853,False
2392,93,1991-08-23,harley davidson and the marlboro man,23000000,7018525,7018525,-15981475,False
2393,94,2007-09-14,in the valley of elah,23000000,6777741,24489150,1489150,False
2394,95,2009-09-25,coco avant chanel,23000000,6113834,50813834,27813834,False
2395,96,2009-06-26,chã©ri,23000000,2715657,2715657,-20284343,False
2396,97,2013-06-28,redemption,23000000,36686,13593473,-9406527,False
2397,98,2008-04-25,rogue,23000000,10452,4673377,-18326623,False
2398,99,2017-05-05,chäi dã n zhuänjiä,23000000,0,58807172,35807172,False
2399,100,2011-03-15,shi yue wei cheng,23000000,0,44195779,21195779,False
2400,1,1987-06-24,spaceballs,22700000,38119483,38119483,15419483,True
2401,2,2007-06-22,1408,22500000,71985628,131263370,108763370,True
2402,3,2016-11-18,nocturnal animals,22500000,10663357,32398681,9898681,False
2403,4,2015-04-24,the water diviner,22500000,4200117,31054727,8554727,False
2404,5,1990-07-13,ghost,22000000,217631306,517600000,495600000,True
2405,6,1998-07-15,there's something about mary,22000000,176484651,369884651,347884651,True
2406,7,1994-11-11,the santa clause,22000000,144833357,189800000,167800000,True
2407,8,2007-09-28,the game plan,22000000,90648202,146590987,124590987,True
2408,9,2002-03-29,the rookie,22000000,75600072,80491516,58491516,True
2409,10,1995-06-02,the bridges of madison county,22000000,71516617,175516617,153516617,True
2410,11,2014-02-28,son of god,22000000,59700064,70949793,48949793,True
2411,12,2001-06-01,the animal,22000000,55762229,55762229,33762229,True
2412,13,2014-08-08,the hundred-foot journey,22000000,54235441,94270488,72270488,True
2413,14,1982-12-08,gandhi,22000000,52767889,127767889,105767889,True
2414,15,2003-09-19,underworld,22000000,51970690,95708457,73708457,True
2415,16,1995-07-28,the net,22000000,50621733,110521733,88521733,True
2416,17,2012-08-03,diary of a wimpy kid: dog days,22000000,49008662,77229695,55229695,True
2417,18,2001-12-28,i am sam,22000000,40270895,92542418,70542418,True
2418,19,2005-11-11,derailed,22000000,36020063,57520063,35520063,True
2419,20,2009-09-18,the informant!,22000000,33316821,41771168,19771168,True
2420,21,2013-11-22,delivery man,22000000,30659817,70536870,48536870,True
2421,22,2016-02-05,"hail, caesar!",22000000,30080225,64160680,42160680,True
2422,23,2001-08-24,jay and silent bob strike back,22000000,30059386,33762400,11762400,True
2423,24,1993-12-29,shadowlands,22000000,25842377,25842377,3842377,True
2424,25,2008-08-27,traitor,22000000,23530831,27882226,5882226,True
2425,26,2005-08-12,deuce bigalow: european gigolo,22000000,22400154,45273464,23273464,True
2426,27,2017-05-19,diary of a wimpy kid: the long haul,22000000,20738724,35609577,13609577,False
2427,28,2008-01-18,mad money,22000000,20668843,25044057,3044057,False
2428,29,2013-11-27,homefront,22000000,20158492,51695362,29695362,False
2429,30,2008-09-19,igor,22000000,19528602,31013349,9013349,False
2430,31,2001-02-09,saving silverman,22000000,19351569,25873142,3873142,False
2431,32,1999-07-02,summer of sam,22000000,19288130,19288130,-2711870,False
2432,33,2001-09-14,the glass house,22000000,17951431,22861785,861785,False
2433,34,2015-09-04,the transporter refueled,22000000,16029670,69698495,47698495,False
2434,35,1980-06-13,the island,22000000,15716828,15716828,-6283172,False
2435,36,2001-04-11,josie and the pussycats,22000000,14252830,14252830,-7747170,False
2436,37,2012-08-22,hit & run,22000000,13749300,17216955,-4783045,False
2437,38,2000-10-27,the little vampire,22000000,13555988,13555988,-8444012,False
2438,39,2004-10-01,i heart huckabees,22000000,12784713,20034713,-1965287,False
2439,40,2017-11-17,"roman j. israel, esq.",22000000,11962712,12967012,-9032988,False
2440,41,2013-12-04,out of the furnace,22000000,11330849,15434375,-6565625,False
2441,42,1993-11-05,robocop 3,22000000,10696210,10696210,-11303790,False
2442,43,1999-08-27,dudley do-right,22000000,9818792,9818792,-12181208,False
2443,44,2017-12-08,just getting started,22000000,6069605,6756412,-15243588,False
2444,45,2001-09-21,megiddo: omega code 2,22000000,6047691,6047691,-15952309,False
2445,46,1970-01-01,darling lili,22000000,5000000,5000000,-17000000,False
2446,47,2005-11-23,the libertine,22000000,4835065,9448623,-12551377,False
2447,48,2007-04-06,zwartboek,22000000,4398532,27238354,5238354,False
2448,49,2014-10-31,before i go to sleep,22000000,3242457,19563579,-2436421,False
2449,50,2010-10-08,stone,22000000,1810078,4065020,-17934980,False
2450,51,2006-03-03,joyeux noã«l,22000000,1054361,23134075,1134075,False
2451,52,2013-12-31,metegol,22000000,0,34061097,12061097,False
2452,53,1977-06-24,sorcerer,21600000,12000000,12005968,-9594032,False
2453,54,2007-07-27,moliã¨re,21600000,635733,791154,-20808846,False
2454,55,2007-10-05,michael clayton,21500000,49033882,92987651,71487651,True
2455,56,1999-07-09,arlington road,21500000,24419219,24419219,2919219,True
2456,57,1996-12-20,my fellow americans,21500000,22331846,22331846,831846,True
2457,58,2012-06-22,to rome with love,21500000,16684352,74326015,52826015,False
2458,59,2012-11-16,silver linings playbook,21000000,132092958,236412453,215412453,True
2459,60,2018-04-06,blockers,21000000,60311495,94045328,73045328,True
2460,61,2019-04-05,pet sematary,21000000,54724696,109501146,88501146,True
2461,62,1999-06-30,"south park: bigger, longer & uncut",21000000,52037603,52037603,31037603,True
2462,63,1982-06-18,firefox,21000000,45785720,45785720,24785720,True
2463,64,2010-04-16,death at a funeral,21000000,42739347,48977233,27977233,True
2464,65,1993-03-19,teenage mutant ninja turtles iii,21000000,42273609,42273609,21273609,True
2465,66,2001-09-14,hardball,21000000,40222729,43728560,22728560,True
2466,67,2010-11-05,for colored girls,21000000,37729698,38017873,17017873,True
2467,68,2007-01-05,freedom writers,21000000,36605602,43632609,22632609,True
2468,69,2017-08-04,kidnap,21000000,30718107,34836080,13836080,True
2469,70,2002-10-11,the transporter,21000000,25296447,43928932,22928932,True
2470,71,2008-03-14,never back down,21000000,24850922,39319801,18319801,True
2471,72,2011-12-09,tinker tailor soldier spy,21000000,24149393,81452811,60452811,True
2472,73,2017-09-22,victoria and abdul,21000000,22245070,68271146,47271146,True
2473,74,1999-11-05,the bachelor,21000000,21731001,36882378,15882378,True
2474,75,1999-03-12,the rage: carrie 2,21000000,17760244,17760244,-3239756,False
2475,76,2008-08-01,swing vote,21000000,16289867,17589867,-3410133,False
2476,77,2009-06-05,away we go,21000000,9451946,10108016,-10891984,False
2477,78,2002-09-27,moonlight mile,21000000,6830957,6830957,-14169043,False
2478,79,2011-05-06,the beaver,21000000,970816,5046038,-15953962,False
2479,80,2017-02-24,bitter harvest,21000000,557241,606162,-20393838,False
2480,81,1999-10-22,molly,21000000,17396,17396,-20982604,False
2481,82,2019-02-01,velvet buzzsaw,21000000,0,0,-21000000,False
2482,83,1999-04-23,existenz,20700000,2840417,2840417,-17859583,False
2483,84,1982-07-23,the best little whorehouse in texas,20500000,69701637,69701637,49201637,True
2484,85,2006-08-11,pulse,20500000,20264436,30241435,9741435,False
2485,86,1991-11-13,beauty and the beast,20000000,376057266,608431132,588431132,True
2486,87,1981-06-12,raiders of the lost ark,20000000,225686079,367452079,347452079,True
2487,88,2019-03-22,us,20000000,175006930,254210310,234210310,True
2488,89,1992-11-20,home alone 2: lost in new york,20000000,173585516,358994850,338994850,True
2489,90,1977-11-16,close encounters of the third kind,20000000,169100479,340800479,320800479,True
2490,91,1987-05-20,beverly hills cop ii,20000000,153665036,276665036,256665036,True
2491,92,2016-12-09,la la land,20000000,151101803,426351163,406351163,True
2492,93,2013-07-19,the conjuring,20000000,137400141,318000141,298000141,True
2493,94,2003-03-07,bringing down the house,20000000,132675402,164675402,144675402,True
2494,95,2017-11-17,wonder,20000000,132422809,304604712,284604712,True
2495,96,1991-02-14,the silence of the lambs,20000000,130726716,275726716,255726716,True
2496,97,1992-02-14,wayne's world,20000000,121697323,183097323,163097323,True
2497,98,2010-10-15,jackass 3d,20000000,117229692,171685793,151685793,True
2498,99,2016-07-29,bad moms,20000000,113257297,180998716,160998716,True
2499,100,2019-01-18,glass,20000000,111035005,245303505,225303505,True
2500,1,1978-06-16,jaws 2,20000000,102922376,208900376,188900376,True
2501,2,2008-10-03,beverly hills chihuahua,20000000,94514402,154218168,134218168,True
2502,3,2014-07-02,tammy,20000000,84525432,96407655,76407655,True
2503,4,2005-01-21,are we there yet?,20000000,82674398,98114471,78114471,True
2504,5,2011-11-16,the descendants,20000000,82624961,175507800,155507800,True
2505,6,2003-10-03,school of rock,20000000,81261177,131944672,111944672,True
2506,7,2007-04-13,disturbia,20000000,80818974,118537627,98537627,True
2507,8,1993-07-16,free willy,20000000,77698625,153698625,133698625,True
2508,9,2016-10-21,tyler perryâs boo! a madea halloween,20000000,73206343,73206343,53206343,True
2509,10,1995-08-18,mortal kombat,20000000,70433227,122133227,102133227,True
2510,11,2004-06-23,white chicks,20000000,69148997,111448997,91448997,True
2511,12,2009-04-24,obsessed,20000000,68261644,73964713,53964713,True
2512,13,2003-04-18,holes,20000000,67383924,71232214,51232214,True
2513,14,2012-06-29,tyler perry's madea's witness protection,20000000,65653242,66950887,46950887,True
2514,15,2010-03-31,the last song,20000000,62950384,92678948,72678948,True
2515,16,2010-04-02,why did i get married too?,20000000,60095852,60831067,40831067,True
2516,17,1998-10-23,la vita ã¨ bella,20000000,57598247,229385361,209385361,True
2517,18,2013-10-18,12 years a slave,20000000,56671993,181025343,161025343,True
2518,19,2002-12-13,drumline,20000000,56398162,56398162,36398162,True
2519,20,2016-06-03,me before you,20000000,56245075,208265198,188265198,True
2520,21,2019-02-08,what men want,20000000,54611903,69911903,49911903,True
2521,22,2016-04-15,barbershop: the next cut,20000000,54030051,54404202,34404202,True
2522,23,1990-12-07,edward scissorhands,20000000,53976987,53976987,33976987,True
2523,24,2018-09-14,a simple favor,20000000,53548586,97628717,77628717,True
2524,25,2015-01-09,selma,20000000,52076908,66776576,46776576,True
2525,26,1980-12-12,popeye,20000000,49823037,49823037,29823037,True
2526,27,2006-02-17,date movie,20000000,48548426,85146165,65146165,True
2527,28,2002-02-15,peter pan: return to neverland,20000000,48430258,109862682,89862682,True
2528,29,2003-02-14,the jungle book 2,20000000,47901582,140122225,120122225,True
2529,30,2007-03-16,premonition,20000000,47852604,81461343,61461343,True
2530,31,2017-10-20,tyler perryâs boo 2! a madea halloween,20000000,47319572,47879572,27879572,True
2531,32,2005-02-04,boogeyman,20000000,46752382,67192859,47192859,True
2532,33,2000-02-11,the tigger movie,20000000,45542421,96147688,76147688,True
2533,34,2015-11-06,spotlight,20000000,45055776,92088460,72088460,True
2534,35,2018-03-30,acrimony,20000000,43549096,46627836,26627836,True
2535,36,2015-06-26,max,20000000,42656255,43658157,23658157,True
2536,37,2008-03-21,meet the browns,20000000,41975388,41975388,21975388,True
2537,38,2009-07-24,orphan,20000000,41596251,78769428,58769428,True
2538,39,2017-11-17,the star,20000000,40847995,62758010,42758010,True
2539,40,2007-01-26,epic movie,20000000,39739367,86858578,66858578,True
2540,41,2008-09-19,lakeview terrace,20000000,39263506,44821299,24821299,True
2541,42,2006-10-13,the grudge 2,20000000,39143839,70743839,50743839,True
2542,43,2016-07-27,nerve,20000000,38583626,70652284,50652284,True
2543,44,1982-05-14,conan the barbarian,20000000,38264085,79114085,59114085,True
2544,45,1998-08-14,how stella got her groove back,20000000,37672944,37672944,17672944,True
2545,46,1991-07-19,bill & ted's bogus journey,20000000,37537675,37537675,17537675,True
2546,47,2006-10-13,man of the year,20000000,37442180,41342180,21342180,True
2547,48,2016-02-19,risen,20000000,36880033,46255763,26255763,True
2548,49,2010-08-18,vampires suck,20000000,36661504,81424988,61424988,True
2549,50,1979-12-21,the black hole,20000000,35841901,35841901,15841901,True
2550,51,2010-09-01,the american,20000000,35606376,67950723,47950723,True
2551,52,1997-03-21,selena,20000000,35450113,35450113,15450113,True
2552,53,2011-11-04,a very harold & kumar 3d christmas,20000000,35061031,36265745,16265745,True
2553,54,2004-03-19,eternal sunshine of the spotless mind,20000000,34366518,72570762,52570762,True
2554,55,2013-01-04,texas chainsaw 3d,20000000,34341945,47666013,27666013,True
2555,56,2006-10-27,babel,20000000,34302837,132121212,112121212,True
2556,57,2014-09-19,this is where i leave you,20000000,34296320,41296320,21296320,True
2557,58,2008-12-12,doubt,20000000,33446470,53191101,33191101,True
2558,59,2004-10-15,team america: world police,20000000,32774834,50948811,30948811,True
2559,60,1995-10-27,copycat,20000000,32051917,32051917,12051917,True
2560,61,2013-04-12,scary movie v,20000000,32015787,78613981,58613981,True
2561,62,2010-03-12,she's out of my league,20000000,32010860,48680977,28680977,True
2562,63,2008-11-26,milk,20000000,31841299,57293371,37293371,True
2563,64,1969-10-15,paint your wagon,20000000,31678778,31678778,11678778,True
2564,65,2011-08-31,the debt,20000000,31177548,46604054,26604054,True
2565,66,2002-10-25,ghost ship,20000000,30113491,68349884,48349884,True
2566,67,2010-01-08,daybreakers,20000000,30101577,51445503,31445503,True
2567,68,2008-03-07,the bank job,20000000,30060660,66143005,46143005,True
2568,69,1998-03-20,wild things,20000000,29795299,55576699,35576699,True
2569,70,2009-10-16,the stepfather,20000000,29062561,29227561,9227561,True
2570,71,2000-03-31,high fidelity,20000000,27277055,47881663,27881663,True
2571,72,2006-04-28,stick it,20000000,26910736,30399714,10399714,True
2572,73,2008-01-04,one missed call,20000000,26890041,44513466,24513466,True
2573,74,1996-01-12,eye for an eye,20000000,26792700,26792700,6792700,True
2574,75,2008-04-11,street kings,20000000,26418667,65457811,45457811,True
2575,76,2013-08-23,the world's end,20000000,26004851,47508505,27508505,True
2576,77,1996-01-19,from dusk till dawn,20000000,25728961,25732986,5732986,True
2577,78,2010-09-24,you again,20000000,25702053,32838945,12838945,True
2578,79,2007-06-15,nancy drew,20000000,25584685,30703845,10703845,True
2579,80,2010-09-17,alpha and omega 3d,20000000,25107267,48958353,28958353,True
2580,81,2018-12-25,on the basis of sex,20000000,24622687,38073377,18073377,True
2581,82,2014-02-14,endless love,20000000,23438250,34718173,14718173,True
2582,83,2006-09-08,the covenant,20000000,23364784,38164784,18164784,True
2583,84,2011-07-01,monte carlo,20000000,23186769,39686769,19686769,True
2584,85,2006-03-24,stay alive,20000000,23086480,23187506,3187506,True
2585,86,2005-10-07,2 for the money,20000000,22991379,30491379,10491379,True
2586,87,2017-06-16,rough night,20000000,22105643,46844357,26844357,True
2587,88,1998-12-04,psycho,20000000,21541218,37226218,17226218,True
2588,89,1990-10-19,quigley down under,20000000,21413105,21413105,1413105,True
2589,90,1995-09-27,to die for,20000000,21284514,27688744,7688744,True
2590,91,2009-08-21,shorts,20000000,20919166,29870801,9870801,True
2591,92,1998-10-30,vampires,20000000,20268825,20268825,268825,True
2592,93,2008-09-19,appaloosa,20000000,20211394,27911453,7911453,True
2593,94,2015-11-20,secret in their eyes,20000000,20180155,32608019,12608019,True
2594,95,2004-08-13,yu-gi-oh,20000000,19762690,28762690,8762690,False
2595,96,2007-03-23,reign over me,20000000,19661987,20081987,81987,False
2596,97,2008-09-19,my best friend's girl,20000000,19219250,34787111,14787111,False
2597,98,2007-05-11,georgia rule,20000000,18882880,20819601,819601,False
2598,99,1981-07-31,under the rainbow,20000000,18826490,18826490,-1173510,False
2599,100,1985-04-12,ladyhawke,20000000,18400000,18400000,-1600000,False
2600,1,2007-09-21,into the wild,20000000,18354356,56822960,36822960,False
2601,2,1998-09-11,simon birch,20000000,18253415,18310591,-1689409,False
2602,3,2005-02-11,pooh's heffalump movie,20000000,18098433,55686944,35686944,False
2603,4,2006-09-29,school for scoundrels,20000000,17807569,17807569,-2192431,False
2604,5,2012-10-26,silent hill: revelation 3d,20000000,17530219,55975672,35975672,False
2605,6,1995-11-03,home for the holidays,20000000,17468887,22119269,2119269,False
2606,7,2017-03-31,the zookeeperâs wife,20000000,17445186,26308749,6308749,False
2607,8,2009-02-20,fired up,20000000,17231291,18608570,-1391430,False
2608,9,2005-04-08,kung fu hustle,20000000,17104669,102034104,82034104,False
2609,10,2002-07-26,the country bears,20000000,16988996,16988996,-3011004,False
2610,11,2017-09-29,flatliners,20000000,16883115,45173738,25173738,False
2611,12,2007-03-16,dead silence,20000000,16574590,20614661,614661,False
2612,13,2003-11-21,21 grams,20000000,16248701,59667625,39667625,False
2613,14,2009-12-04,armored,20000000,15988876,23661038,3661038,False
2614,15,2007-12-14,the kite runner,20000000,15800078,74180745,54180745,False
2615,16,2004-09-03,paparazzi,20000000,15712072,16612072,-3387928,False
2616,17,2003-01-17,a guy thing,20000000,15543862,17430594,-2569406,False
2617,18,1965-02-15,the greatest story ever told,20000000,15473333,15473333,-4526667,False
2618,19,2000-07-21,loser,20000000,15464026,18250106,-1749894,False
2619,20,1998-03-06,twilight,20000000,15055091,15055091,-4944909,False
2620,21,2009-09-23,capitalism: a love story,20000000,14363397,19121531,-878469,False
2621,22,2012-04-13,lockout,20000000,14326865,33943049,13943049,False
2622,23,2008-08-29,disaster movie,20000000,14190901,36720752,16720752,False
2623,24,2011-09-30,what's your number?,20000000,14011084,30163785,10163785,False
2624,25,1997-11-14,the man who knew too little,20000000,13801755,13801755,-6198245,False
2625,26,2009-04-17,crank 2: high voltage,20000000,13684249,35472739,15472739,False
2626,27,2015-10-30,burnt,20000000,13651946,36773510,16773510,False
2627,28,2004-04-30,envy,20000000,13548322,14566246,-5433754,False
2628,29,2006-10-13,one night with the king,20000000,13395961,13725032,-6274968,False
2629,30,1994-10-21,bullets over broadway,20000000,13383747,13383747,-6616253,False
2630,31,2008-09-19,ghost town,20000000,13367624,29958228,9958228,False
2631,32,2002-11-22,the quiet american,20000000,12987647,26348203,6348203,False
2632,33,2016-02-26,triple 9,20000000,12639297,25943792,5943792,False
2633,34,2016-09-02,the light between oceans,20000000,12545979,22281732,2281732,False
2634,35,2005-10-28,the weather man,20000000,12482775,15466961,-4533039,False
2635,36,2002-08-23,undisputed,20000000,12398628,12398628,-7601372,False
2636,37,2009-03-27,12 rounds,20000000,12234694,17306648,-2693352,False
2637,38,2010-10-01,let me in,20000000,12134935,28270399,8270399,False
2638,39,1994-05-06,3 ninjas kick back,20000000,11744960,11744960,-8255040,False
2639,40,2008-02-22,be kind rewind,20000000,11175164,30894247,10894247,False
2640,41,2005-12-09,mrs. henderson presents,20000000,11036366,27836366,7836366,False
2641,42,1997-12-12,deconstructing harry,20000000,10686841,10686841,-9313159,False
2642,43,1999-10-22,three to tango,20000000,10570375,10570375,-9429625,False
2643,44,1989-12-15,we're no angels,20000000,10555348,10555348,-9444652,False
2644,45,1996-12-06,everyone says i love you,20000000,9725847,34600000,14600000,False
2645,46,2007-08-31,death sentence,20000000,9534258,16907831,-3092169,False
2646,47,2016-06-03,popstar: never stop never stopping,20000000,9496130,9537120,-10462880,False
2647,48,2017-10-27,thank you for your service,20000000,9479390,9985316,-10014684,False
2648,49,2009-12-04,everybody's fine,20000000,9208876,9208876,-10791124,False
2649,50,2004-08-27,superbabies: baby geniuses 2,20000000,9109322,9355369,-10644631,False
2650,51,2013-09-20,battle of the year,20000000,8888355,16723377,-3276623,False
2651,52,2016-04-29,ratchet and clank,20000000,8813410,14365639,-5634361,False
2652,53,2007-08-17,death at a funeral,20000000,8580428,46790428,26790428,False
2653,54,2005-09-09,the man,20000000,8330720,10393696,-9606304,False
2654,55,2007-01-05,code name: the cleaner,20000000,8135024,8135024,-11864976,False
2655,56,2014-12-12,inherent vice,20000000,8110975,14772346,-5227654,False
2656,57,2004-04-16,connie & carla,20000000,8047525,8047525,-11952475,False
2657,58,2013-10-11,machete kills,20000000,8008161,18273009,-1726991,False
2658,59,1969-01-01,sweet charity,20000000,8000000,8000000,-12000000,False
2659,60,2006-02-24,doogal,20000000,7578946,28058652,8058652,False
2660,61,2005-09-16,proof,20000000,7535331,8284331,-11715669,False
2661,62,2008-10-03,an american carol,20000000,7013191,7022183,-12977817,False
2662,63,2003-03-14,willard,20000000,6882696,6882696,-13117304,False
2663,64,2008-02-01,strange wilderness,20000000,6575282,6947084,-13052916,False
2664,65,2015-04-24,little boy,20000000,6485961,17769299,-2230701,False
2665,66,1999-12-17,topsy turvy,20000000,6201757,6201757,-13798243,False
2666,67,2012-10-26,chasing mavericks,20000000,6002756,8300821,-11699179,False
2667,68,2014-12-31,a most violent year,20000000,5749134,8846875,-11153125,False
2668,69,2011-11-23,a dangerous method,20000000,5702083,14807531,-5192469,False
2669,70,2006-07-07,a scanner darkly,20000000,5501616,7405084,-12594916,False
2670,71,2009-08-14,bandslam,20000000,5210988,12967829,-7032171,False
2671,72,2005-01-28,alone in the dark,20000000,5178569,10588079,-9411921,False
2672,73,2004-10-29,birth,20000000,5005899,14603001,-5396999,False
2673,74,2016-08-26,hands of stone,20000000,4712792,5031975,-14968025,False
2674,75,2008-10-24,passchendaele,20000000,4452423,4453327,-15546673,False
2675,76,2008-10-03,flash of genius,20000000,4442377,4504111,-15495889,False
2676,77,2007-11-21,iâm not there,20000000,4017609,12397613,-7602387,False
2677,78,2012-09-07,the cold light of day,20000000,3763583,25361206,5361206,False
2678,79,2009-05-15,the brothers bloom,20000000,3531756,5531756,-14468244,False
2679,80,2008-10-24,"synecdoche, new york",20000000,3083538,4383538,-15616462,False
2680,81,2018-10-26,suspiria,20000000,2483472,7034615,-12965385,False
2681,82,2017-11-03,lbj,20000000,2468683,2507181,-17492819,False
2682,83,1999-10-29,mononoke-hime,20000000,2374107,150350000,130350000,False
2683,84,2004-03-19,bon voyage,20000000,2353728,8361736,-11638264,False
2684,85,2015-11-13,my all-american,20000000,2246000,2246000,-17754000,False
2685,86,1980-06-20,can't stop the music,20000000,2000000,2000000,-18000000,False
2686,87,2006-05-05,the proposition,20000000,1903434,5313608,-14686392,False
2687,88,2003-08-22,marci x,20000000,1646664,1646664,-18353336,False
2688,89,2002-12-06,equilibrium,20000000,1190018,5345869,-14654131,False
2689,90,2011-04-29,dylan dog: dead of night,20000000,1186538,6093725,-13906275,False
2690,91,2012-08-29,the oogieloves in the big balloon adventure,20000000,1065907,1065907,-18934093,False
2691,92,2008-05-23,the children of huang shi,20000000,1031872,8221700,-11778300,False
2692,93,2000-10-20,the yards,20000000,882710,2282710,-17717290,False
2693,94,2010-08-06,middle men,20000000,754301,754301,-19245699,False
2694,95,2017-04-28,jã¬yã¬ dã shä«,20000000,587470,43888531,23888531,False
2695,96,2010-12-03,all good things,20000000,582024,873617,-19126383,False
2696,97,2015-11-13,by the sea,20000000,538460,3727746,-16272254,False
2697,98,2005-03-18,steamboy,20000000,468867,10468867,-9531133,False
2698,99,2005-04-22,the game of their lives,20000000,375474,375474,-19624526,False
2699,100,1994-09-11,rapa nui,20000000,305070,305070,-19694930,False
2700,1,2010-12-10,the tempest,20000000,277943,277943,-19722057,False
2701,2,2008-03-07,é·æ±ä¸è (cj7),20000000,206678,47300771,27300771,False
2702,3,2009-09-18,the burning plain,20000000,200730,1167092,-18832908,False
2703,4,1998-03-27,les couloirs du temps: les visiteurs 2,20000000,146072,26146072,6146072,False
2704,5,2003-04-25,people i know,20000000,121972,5694213,-14305787,False
2705,6,2015-10-30,regression,20000000,55039,15824374,-4175626,False
2706,7,2008-12-31,admiral,20000000,0,38585047,18585047,False
2707,8,2012-12-31,zambezia,20000000,0,34454336,14454336,False
2708,9,2010-04-13,three kingdoms: resurrection of the dragon,20000000,0,22139590,2139590,False
2709,10,2004-03-31,the touch,20000000,0,5918742,-14081258,False
2710,11,2015-05-29,survivor,20000000,0,1703281,-18296719,False
2711,12,2016-11-18,the history of love,20000000,0,476624,-19523376,False
2712,13,2007-12-25,butterfly on a wheel,20000000,0,0,-20000000,False
2713,14,2014-08-29,dwegons and leprechauns,20000000,0,0,-20000000,False
2714,15,2016-07-22,fight valley,20000000,0,0,-20000000,False
2715,16,2017-12-31,the thousand miles,20000000,0,0,-20000000,False
2716,17,2018-12-13,bird box,19800000,0,0,-19800000,False
2717,18,2009-08-21,der baader meinhof komplex,19700000,476270,16498827,-3201173,False
2718,19,2017-12-01,the shape of water,19500000,63859435,195790794,176290794,True
2719,20,2012-11-23,de rouille et dâos,19500000,2061449,29393634,9893634,False
2720,21,2006-12-20,the painted veil,19400000,8060487,15118795,-4281205,False
2721,22,2013-08-23,the frozen ground,19200000,0,5617460,-13582540,False
2722,23,2011-07-29,the devil's double,19100000,1361512,5965646,-13134354,False
2723,24,1985-07-03,back to the future,19000000,212259762,385524784,366524784,True
2724,25,1990-11-09,dances with wolves,19000000,184208842,424200000,405200000,True
2725,26,2000-07-07,scary movie,19000000,157019771,277200000,258200000,True
2726,27,2011-06-24,bad teacher,19000000,100292856,215448997,196448997,True
2727,28,2016-08-12,sausage party,19000000,97670358,141344255,122344255,True
2728,29,1989-09-15,sea of love,19000000,58571513,58571513,39571513,True
2729,30,2003-01-10,just married,19000000,56127162,101564935,82564935,True
2730,31,2009-09-11,i can do bad all by myself,19000000,51733921,51733921,32733921,True
2731,32,2004-07-16,a cinderella story,19000000,51438175,70164105,51164105,True
2732,33,1980-05-23,the shining,19000000,44017374,44728227,25728227,True
2733,34,2001-10-26,thirteen ghosts,19000000,41867960,68467960,49467960,True
2734,35,1999-10-29,house on haunted hill,19000000,40846082,65090541,46090541,True
2735,36,2010-02-26,the crazies,19000000,39123589,56445534,37445534,True
2736,37,2009-01-16,notorious,19000000,36843682,44972183,25972183,True
2737,38,2018-11-02,nobodyâs fool,19000000,31713110,32589493,13589493,True
2738,39,2010-08-20,the switch,19000000,27758465,49858465,30858465,True
2739,40,2010-01-08,leap year,19000000,25918920,32618920,13618920,True
2740,41,2013-11-08,the book thief,19000000,21488481,76086711,57086711,True
2741,42,2007-10-19,"gone, baby, gone",19000000,20300218,34352162,15352162,True
2742,43,2000-07-26,thomas and the magic railroad,19000000,15911332,15911332,-3088668,False
2743,44,1962-11-08,mutiny on the bounty,19000000,13680000,13680000,-5320000,False
2744,45,2002-09-20,sen to chihiro no kamikakushi,19000000,10049886,274949886,255949886,False
2745,46,2008-10-17,sex drive,19000000,8402485,10412485,-8587515,False
2746,47,1998-01-09,firestorm,19000000,8123860,8123860,-10876140,False
2747,48,2011-03-04,take me home tonight,19000000,6928068,7576604,-11423396,False
2748,49,2012-09-28,won't back down,19000000,5310554,5745503,-13254497,False
2749,50,2018-06-01,action point,19000000,5059608,5103675,-13896325,False
2750,51,1964-01-01,the fall of the roman empire,19000000,4750000,4750000,-14250000,False
2751,52,1993-11-24,the nutcracker,19000000,2119994,2119994,-16880006,False
2752,53,2011-12-13,george balanchine\'s the nutcracker,19000000,2119994,2119994,-16880006,False
2753,54,1996-08-16,kansas city,19000000,1353824,1353824,-17646176,False
2754,55,2016-03-08,out of the inferno,19000000,0,0,-19000000,False
2755,56,2005-06-24,george a. romero's land of the dead,18975000,20700082,47751015,28776015,True
2756,57,2006-12-15,indigã¨nes,18900000,320700,26063572,7163572,False
2757,58,2005-04-15,the amityville horror,18500000,65233369,109175673,90675673,True
2758,59,2002-12-06,adaptation,18500000,22498520,32531759,14031759,True
2759,60,2009-10-02,the invention of lying,18500000,18451251,32679264,14179264,False
2760,61,1998-05-22,fear and loathing in las vegas,18500000,10680275,13711903,-4788097,False
2761,62,2008-07-04,ne le dis ã personne,18500000,6198883,33954018,15454018,False
2762,63,2001-02-02,left behind,18500000,4221341,4221341,-14278659,False
2763,64,2014-05-09,neighbors,18000000,150086800,270944428,252944428,True
2764,65,2006-11-03,borat,18000000,128505958,261443242,243443242,True
2765,66,1994-07-29,the mask,18000000,119920129,351620129,333620129,True
2766,67,1988-06-03,big,18000000,114968774,151668774,133668774,True
2767,68,2001-07-13,legally blonde,18000000,96493426,141809235,123809235,True
2768,69,2004-04-30,mean girls,18000000,86047227,130953026,112953026,True
2769,70,1984-06-01,star trek iii: the search for spock,18000000,76471046,87000000,69000000,True
2770,71,2005-09-09,the exorcism of emily rose,18000000,75072454,144529078,126529078,True
2771,72,1999-12-10,deuce bigalow: male gigolo,18000000,65535067,92935067,74935067,True
2772,73,2004-01-01,barbershop 2: back in business,18000000,65070412,65842412,47842412,True
2773,74,2005-12-16,the family stone,18000000,60062868,92357499,74357499,True
2774,75,2003-11-26,bad santa,18000000,60060328,77147031,59147031,True
2775,76,1987-06-12,predator,18000000,59735548,98267558,80267558,True
2776,77,2016-03-25,my big fat greek wedding 2,18000000,59689605,92096558,74096558,True
2777,78,2015-09-11,the perfect guy,18000000,57027435,60278166,42278166,True
2778,79,1997-05-02,austin powers: international man of mystery,18000000,53883989,67683989,49683989,True
2779,80,2011-03-25,diary of a wimpy kid: rodrick rules,18000000,52698535,73695194,55695194,True
2780,81,1984-09-19,amadeus,18000000,51973029,51973029,33973029,True
2781,82,2008-04-11,prom night,18000000,43869350,57193655,39193655,True
2782,83,2011-04-08,soul surfer,18000000,43853424,47158652,29158652,True
2783,84,2003-09-26,under the tuscan sun,18000000,43601508,57490024,39490024,True
2784,85,2018-06-29,uncle drew,18000000,42469946,46527161,28527161,True
2785,86,2014-10-17,birdman or (the unexpected virtue of ignorance),18000000,42340598,103215094,85215094,True
2786,87,1986-10-10,peggy sue got married,18000000,41382841,41382841,23382841,True
2787,88,2001-12-26,gosford park,18000000,41300105,41300105,23300105,True
2788,89,2002-01-11,orange county,18000000,41059716,43308707,25308707,True
2789,90,2013-07-26,blue jasmine,18000000,33404871,102912961,84912961,True
2790,91,2006-04-28,united 93,18000000,31567134,77635035,59635035,True
2791,92,2003-12-05,honey,18000000,30272254,62646763,44646763,True
2792,93,2005-10-14,the fog,18000000,29511112,37048526,19048526,True
2793,94,1996-05-24,spy hard,18000000,26936265,26936265,8936265,True
2794,95,2015-08-07,ricki and the flash,18000000,26839498,41166033,23166033,True
2795,96,1989-12-13,glory,18000000,26593580,26593580,8593580,True
2796,97,1984-06-29,conan the destroyer,18000000,26400000,26400000,8400000,True
2797,98,2015-11-13,love the coopers,18000000,26302731,42227490,24227490,True
2798,99,1970-06-24,catch-22,18000000,24911670,24911670,6911670,True
2799,100,2009-04-10,observe and report,18000000,24007324,27148898,9148898,True
2800,1,1980-11-14,raging bull,18000000,23380203,23380203,5380203,True
2801,2,2009-09-18,love happens,18000000,22965110,36133014,18133014,True
2802,3,2009-09-25,fame,18000000,22455510,80227619,62227619,True
2803,4,2017-04-28,the circle,18000000,20497844,40651864,22651864,True
2804,5,1985-12-04,young sherlock holmes,18000000,19739000,19739000,1739000,True
2805,6,2010-11-05,127 hours,18000000,18335230,60217171,42217171,True
2806,7,2000-05-19,small time crooks,18000000,17266359,29934477,11934477,False
2807,8,2000-05-12,center stage,18000000,17200925,21361109,3361109,False
2808,9,2016-01-15,norm of the north,18000000,17062499,30535660,12535660,False
2809,10,2004-02-06,catch that kid,18000000,16703799,16959614,-1040386,False
2810,11,2013-08-16,jobs,18000000,16131410,43402515,25402515,False
2811,12,2001-10-26,life as a house,18000000,15652637,23889158,5889158,False
2812,13,2010-01-08,youth in revolt,18000000,15285588,19685588,1685588,False
2813,14,2014-07-25,and so it goes,18000000,15160801,17920013,-79987,False
2814,15,2009-07-10,"i love you, beth cooper",18000000,14800725,16382538,-1617462,False
2815,16,1981-07-24,blow out,18000000,13747234,13747234,-4252766,False
2816,17,2001-03-30,the tailor of panama,18000000,13491653,27491653,9491653,False
2817,18,1981-05-22,the legend of the lone ranger,18000000,13400000,13400000,-4600000,False
2818,19,2014-01-31,labor day,18000000,13371528,14189810,-3810190,False
2819,20,2013-08-30,getaway,18000000,10501938,11813989,-6186011,False
2820,21,1997-09-26,the ice storm,18000000,8038061,16011975,-1988025,False
2821,22,2004-10-15,being julia,18000000,7739049,14488705,-3511295,False
2822,23,1989-03-22,troop beverly hills,18000000,7190505,7190505,-10809495,False
2823,24,1986-02-21,nine 1/2 weeks,18000000,6734844,6734844,-11265156,False
2824,25,2010-01-15,the last station,18000000,6617867,15696146,-2303854,False
2825,26,1981-06-26,dragonslayer,18000000,6000000,6000000,-12000000,False
2826,27,1994-09-30,ed wood,18000000,5828466,5828466,-12171534,False
2827,28,2008-06-06,mongol,18000000,5705761,27147349,9147349,False
2828,29,2008-10-08,rocknrolla,18000000,5700626,27794339,9794339,False
2829,30,1982-06-25,megaforce,18000000,5675599,5675599,-12324401,False
2830,31,2010-08-20,mao's last dancer,18000000,4806750,25941437,7941437,False
2831,32,1996-12-25,hamlet,18000000,4501094,7129670,-10870330,False
2832,33,2014-04-11,the railway man,18000000,4438438,23910210,5910210,False
2833,34,1995-12-29,restoration,18000000,4100000,4100000,-13900000,False
2834,35,2016-03-18,midnight special,18000000,3712282,7680250,-10319750,False
2835,36,2016-11-25,miss sloane,18000000,3500605,7719630,-10280370,False
2836,37,2013-09-27,metallica through the never,18000000,3419967,9082906,-8917094,False
2837,38,2003-09-19,anything else,18000000,3203044,13203044,-4796956,False
2838,39,1996-02-23,unforgettable,18000000,2483790,2483790,-15516210,False
2839,40,2017-03-17,t2: trainspotting,18000000,2402004,42091262,24091262,False
2840,41,2009-12-30,das weisse band: eine deutsche kindergeschichte,18000000,2222862,25727044,7727044,False
2841,42,1986-04-25,8 million ways to die,18000000,1305114,1305114,-16694886,False
2842,43,2013-03-01,phantom,18000000,1034589,1199510,-16800490,False
2843,44,2002-04-26,the salton sea,18000000,676698,676698,-17323302,False
2844,45,2009-04-24,the informers,18000000,315000,315000,-17685000,False
2845,46,1999-09-24,one man's hero,18000000,229311,229311,-17770689,False
2846,47,2010-10-15,carlos,18000000,145526,1619153,-16380847,False
2847,48,2006-09-22,renaissance,18000000,70644,2401413,-15598587,False
2848,49,2008-12-31,i come with the rain,18000000,0,627422,-17372578,False
2849,50,2016-04-15,i am wrath,18000000,0,309608,-17690392,False
2850,51,2014-11-14,wolves,18000000,0,94953,-17905047,False
2851,52,2008-04-08,day of the dead,18000000,0,0,-18000000,False
2852,53,2014-08-22,the prince,18000000,0,0,-18000000,False
2853,54,2016-02-19,forsaken,18000000,0,0,-18000000,False
2854,55,1985-06-28,red sonja,17900000,6905861,6908640,-10991360,False
2855,56,2012-07-13,red lights,17700000,49521,14518884,-3181116,False
2856,57,2007-08-17,superbad,17500000,121463226,169955142,152455142,True
2857,58,2009-02-20,madea goes to jail,17500000,90508336,90508336,73008336,True
2858,59,2008-02-14,step up 2 the streets,17500000,58017783,148586910,131086910,True
2859,60,2006-01-13,hoodwinked,17500000,51386611,109843390,92343390,True
2860,61,2004-12-22,hotel rwanda,17500000,23519128,36521223,19021223,True
2861,62,2006-08-25,beerfest,17500000,19185184,20159316,2659316,True
2862,63,2013-11-27,black nativity,17500000,7018188,7285135,-10214865,False
2863,64,2003-04-25,city of ghosts,17500000,325491,325491,-17174509,False
2864,65,2007-12-31,taxi 4,17500000,0,60865364,43365364,False
2865,66,2018-04-06,a quiet place,17000000,188024361,334522294,317522294,True
2866,67,2001-08-10,the others,17000000,96522687,207765056,190765056,True
2867,68,1986-07-18,aliens,17000000,85160248,183316455,166316455,True
2868,69,2014-08-13,letâs be cops,17000000,82390774,136890774,119890774,True
2869,70,1997-10-17,i know what you did last summer,17000000,72250091,125250091,108250091,True
2870,71,1964-10-22,my fair lady,17000000,72000000,72071636,55071636,True
2871,72,2004-10-22,sideways,17000000,71502303,109793192,92793192,True
2872,73,2013-11-15,the best man holiday,17000000,70525195,72835710,55835710,True
2873,74,2009-02-13,friday the 13th,17000000,65002019,92670237,75670237,True
2874,75,2012-09-28,pitch perfect,17000000,65001093,116044347,99044347,True
2875,76,1998-08-05,halloween: h2o,17000000,55041738,55041738,38041738,True
2876,77,2013-04-05,evil dead,17000000,54239856,97778356,80778356,True
2877,78,2004-08-27,jet li's hero,17000000,53652140,177535958,160535958,True
2878,79,2010-10-29,saw 3d,17000000,45710178,133735284,116735284,True
2879,80,2015-02-20,"mcfarland, usa",17000000,44480275,45707924,28707924,True
2880,81,2016-11-11,almost christmas,17000000,42065185,42493506,25493506,True
2881,82,2006-03-10,the hills have eyes,17000000,41778863,70355813,53355813,True
2882,83,2002-03-01,40 days and 40 nights,17000000,37939782,95092667,78092667,True
2883,84,2003-10-10,good boy!,17000000,37667746,45312217,28312217,True
2884,85,2007-01-26,smokin' aces,17000000,35662731,57263440,40263440,True
2885,86,1998-10-02,a night at the roxbury,17000000,30331165,30331165,13331165,True
2886,87,2011-03-04,beastly,17000000,27865571,38028230,21028230,True
2887,88,2010-03-05,brooklyn's finest,17000000,27163593,39233233,22233233,True
2888,89,1982-07-09,tron,17000000,26918576,26918576,9918576,True
2889,90,2010-08-20,lottery ticket,17000000,24719879,24719879,7719879,True
2890,91,2003-09-05,dickie roberts: former child star,17000000,22734486,23734486,6734486,True
2891,92,2006-03-31,atl,17000000,21170563,21170563,4170563,True
2892,93,2001-08-24,summer catch,17000000,19693891,19693891,2693891,True
2893,94,1998-12-11,a simple plan,17000000,16316273,16316273,-683727,False
2894,95,2006-03-24,larry the cable guy: health inspector,17000000,15680099,15680099,-1319901,False
2895,96,2002-11-27,wes craven presents: they,17000000,12840842,16140842,-859158,False
2896,97,1999-10-01,the adventures of elmo in grouchland,17000000,11634458,11634458,-5365542,False
2897,98,1987-07-24,superman iv: the quest for peace,17000000,11227824,11227824,-5772176,False
2898,99,1963-05-29,55 days at peking,17000000,10000000,10000000,-7000000,False
2899,100,2009-06-05,my life in ruins,17000000,8677425,20477425,3477425,False
2900,1,2006-04-21,american dreamz,17000000,7314027,16510971,-489029,False
2901,2,2008-01-25,how she move,17000000,7070641,8607815,-8392185,False
2902,3,2006-02-24,running scared,17000000,6855137,9729088,-7270912,False
2903,4,2012-08-24,the apparition,17000000,4936819,10637281,-6362719,False
2904,5,2004-04-30,bobby jones: stroke of genius,17000000,2694071,2694071,-14305929,False
2905,6,1986-08-29,shanghai surprise,17000000,2315000,2315000,-14685000,False
2906,7,2010-12-25,l'illusionniste,17000000,2231474,8609949,-8390051,False
2907,8,1981-01-01,roar,17000000,2110050,2110050,-14889950,False
2908,9,2003-10-17,veronica guerin,17000000,1569918,9438074,-7561926,False
2909,10,2016-06-10,genius,17000000,1361045,7265283,-9734717,False
2910,11,2007-11-14,southland tales,17000000,275380,364607,-16635393,False
2911,12,2015-06-26,escobar: paradise lost,17000000,195792,3917679,-13082321,False
2912,13,2017-09-26,"mune, le gardien de la lune",17000000,0,14534046,-2465954,False
2913,14,2009-06-23,chasseurs de dragons,17000000,0,13446115,-3553885,False
2914,15,1977-10-21,damnation alley,17000000,0,0,-17000000,False
2915,16,2019-07-12,crawl,17000000,0,0,-17000000,False
2916,17,2016-03-11,the young messiah,16800000,6469813,7313697,-9486303,False
2917,18,2006-11-10,fur: an imaginary portrait of diane arbus,16800000,223202,2281089,-14518911,False
2918,19,1991-11-27,my girl,16500000,58011485,58011485,41511485,True
2919,20,1987-12-11,wall street,16500000,43848100,43848100,27348100,True
2920,21,1995-12-11,sense and sensibility,16500000,42993774,134993774,118493774,True
2921,22,2006-08-18,the illusionist,16500000,39868642,83792062,67292062,True
2922,23,2007-08-03,becoming jane,16500000,18663911,39380876,22880876,True
2923,24,2003-12-19,house of sand and fog,16500000,13005485,16157923,-342077,False
2924,25,2007-09-21,sydney white,16500000,11892415,13636339,-2863661,False
2925,26,2007-12-31,arn - tempelriddaren,16500000,0,21404122,4904122,False
2926,27,1989-06-02,dead poets society,16400000,95860116,239500000,223100000,True
2927,28,1994-12-16,dumb & dumber,16000000,127175374,246400000,230400000,True
2928,29,1989-07-14,when harry met sallyâ¦,16000000,92823546,92961960,76961960,True
2929,30,2000-05-19,road trip,16000000,68525609,119739110,103739110,True
2930,31,1982-12-08,the verdict,16000000,53977250,53977250,37977250,True
2931,32,1999-01-15,varsity blues,16000000,52894169,54294169,38294169,True
2932,33,2012-05-25,moonrise kingdom,16000000,45512466,68848446,52848446,True
2933,34,2011-11-25,the artist,16000000,44667095,128256712,112256712,True
2934,35,2009-01-09,the unborn,16000000,42670410,78208812,62208812,True
2935,36,2002-08-02,the master of disguise,16000000,40363530,40363530,24363530,True
2936,37,2006-10-06,the texas chainsaw massacre: the beginning,16000000,39517763,50517763,34517763,True
2937,38,2006-12-29,el laberinto del fauno,16000000,37634615,87041569,71041569,True
2938,39,2011-02-04,the roommate,16000000,37300107,52545707,36545707,True
2939,40,2007-02-02,the messengers,16000000,35374833,53774833,37774833,True
2940,41,2001-03-02,see spot run,16000000,33357476,43057552,27057552,True
2941,42,1991-08-09,double impact,16000000,29090445,29090445,13090445,True
2942,43,2001-06-27,baby boy,16000000,28734552,28734552,12734552,True
2943,44,2001-04-11,joe dirt,16000000,27087695,30987695,14987695,True
2944,45,2008-09-12,the women,16000000,26902075,50103808,34103808,True
2945,46,2007-04-20,hot fuzz,16000000,23618786,81742618,65742618,True
2946,47,2008-08-15,vicky cristina barcelona,16000000,23216709,104504817,88504817,True
2947,48,2000-06-16,boys and girls,16000000,21799652,21799652,5799652,True
2948,49,2018-06-13,superfly,16000000,20537137,20723581,4723581,True
2949,50,1994-11-18,lã©on,16000000,19284974,45284974,29284974,True
2950,51,2010-03-12,remember me,16000000,19068240,56506120,40506120,True
2951,52,2002-10-11,white oleander,16000000,16357770,21657770,5657770,True
2952,53,2009-09-18,jennifer's body,16000000,16204793,31943401,15943401,True
2953,54,2000-03-03,drowning mona,16000000,15427192,15980376,-19624,False
2954,55,1987-01-30,radio days,16000000,14792779,14792779,-1207221,False
2955,56,2003-07-18,how to deal,16000000,14108518,14108518,-1891482,False
2956,57,2014-10-03,left behind,16000000,14019924,20769209,4769209,False
2957,58,2004-05-28,soul plane,16000000,13922211,14553807,-1446193,False
2958,59,1988-12-09,my stepmother is an alien,16000000,13854000,13854000,-2146000,False
2959,60,2012-06-29,people like us,16000000,12431792,12617472,-3382528,False
2960,61,1999-05-28,the thirteenth floor,16000000,11810854,11810854,-4189146,False
2961,62,2004-09-03,the cookout,16000000,11540112,11540112,-4459888,False
2962,63,1979-10-19,meteor,16000000,8400000,8400000,-7600000,False
2963,64,1986-03-07,highlander,16000000,5900000,12900000,-3100000,False
2964,65,2016-11-18,bleed for this,16000000,5083906,6603926,-9396074,False
2965,66,2002-05-03,hollywood ending,16000000,4839383,14839383,-1160617,False
2966,67,2000-09-15,duets,16000000,4734235,6615452,-9384548,False
2967,68,1999-08-13,detroit rock city,16000000,4217115,5825314,-10174686,False
2968,69,2007-10-19,things we lost in the fire,16000000,3287315,8120148,-7879852,False
2969,70,2014-11-14,the homesman,16000000,2429989,8217571,-7782429,False
2970,71,2013-04-05,trance,16000000,2322593,22594052,6594052,False
2971,72,2014-05-16,the immigrant,16000000,2013456,7585011,-8414989,False
2972,73,1997-08-15,steel,16000000,1686429,1686429,-14313571,False
2973,74,2005-12-21,the white countess,16000000,1669971,2814566,-13185434,False
2974,75,2008-07-25,bienvenue chez les ch'tis,16000000,1477650,247474497,231474497,False
2975,76,2014-10-01,"men, women and children",16000000,705908,1685403,-14314597,False
2976,77,2010-09-24,enter the void,16000000,337997,1467278,-14532722,False
2977,78,2008-12-31,good,16000000,31631,31631,-15968369,False
2978,79,2012-11-02,vamps,16000000,3361,94812,-15905188,False
2979,80,2010-05-11,haeundae,16000000,0,64733391,48733391,False
2980,81,2010-03-09,hachiko: a dog's story,16000000,0,47707417,31707417,False
2981,82,2013-12-31,zulu,16000000,0,1844228,-14155772,False
2982,83,2018-12-21,second act,15700000,39282227,63288854,47588854,True
2983,84,2002-06-21,juwanna mann,15600000,13571817,13771817,-1828183,False
2984,85,2007-06-08,la mã´me,15500000,10299782,88611837,73111837,False
2985,86,2002-11-15,ararat,15500000,1693000,1693000,-13807000,False
2986,87,2007-04-13,slow burn,15500000,1237615,1237615,-14262385,False
2987,88,2005-04-22,madison,15500000,517262,517262,-14982738,False
2988,89,2010-02-26,the yellow handkerchief,15500000,318623,318623,-15181377,False
2989,90,2002-09-27,wasabi,15300000,81525,7000000,-8300000,False
2990,91,2006-03-31,slither,15250000,7802450,12930343,-2319657,False
2991,92,1990-11-16,home alone,15000000,285761243,476684675,461684675,True
2992,93,1984-12-05,beverly hills cop,15000000,234760478,316300000,301300000,True
2993,94,1986-05-16,top gun,15000000,179800601,356799634,341799634,True
2994,95,1982-12-17,tootsie,15000000,177200000,177200000,162200000,True
2995,96,1987-11-25,3 men and a baby,15000000,167780960,167780960,152780960,True
2996,97,2010-11-26,the kingâs speech,15000000,138797449,430821168,415821168,True
2997,98,1999-09-15,american beauty,15000000,130058047,356258047,341258047,True
2998,99,2000-12-08,"crouching tiger, hidden dragon",15000000,128067808,213514672,198514672,True
2999,100,1988-12-09,twins,15000000,111936388,216600000,201600000,True
3000,1,1996-12-20,scream,15000000,103046663,173046663,158046663,True
3001,2,2017-08-11,annabelle: creation,15000000,102092201,305384865,290384865,True
3002,3,2013-10-25,jackass presents: bad grandpa,15000000,102003019,160903019,145903019,True
3003,4,1978-06-28,heaven can wait,15000000,98800000,98800000,83800000,True
3004,5,1985-12-18,the color purple,15000000,93589701,93589701,78589701,True
3005,6,2014-11-28,the imitation game,15000000,91125143,227740463,212740463,True
3006,7,1988-03-30,beetlejuice,15000000,73839613,73887546,58887546,True
3007,8,1959-11-18,ben-hur,15000000,73000000,73259017,58259017,True
3008,9,2013-01-18,mama,15000000,71628180,148095566,133095566,True
3009,10,1980-10-10,private benjamin,15000000,69847348,69847348,54847348,True
3010,11,1980-03-07,coal miner's daughter,15000000,67182787,67182787,52182787,True
3011,12,1987-03-06,lethal weapon,15000000,65192350,120192350,105192350,True
3012,13,2010-03-19,diary of a wimpy kid,15000000,64003625,76954311,61954311,True
3013,14,1983-07-29,national lampoonâs vacation,15000000,61400000,61400000,46400000,True
3014,15,2007-08-31,halloween,15000000,58269151,77514401,62514401,True
3015,16,2006-09-30,the queen,15000000,56441711,128885873,113885873,True
3016,17,2007-10-12,why did i get married?,15000000,55204525,55934178,40934178,True
3017,18,2012-02-03,the woman in black,15000000,54333290,128955898,113955898,True
3018,19,1994-12-21,little women,15000000,50003303,50003303,35003303,True
3019,20,1979-01-01,the deer hunter,15000000,50000000,50009253,35009253,True
3020,21,2018-08-10,blackkklansman,15000000,49275340,93017335,78017335,True
3021,22,2006-02-03,when a stranger calls,15000000,47860214,67215435,52215435,True
3022,23,2002-02-08,big fat liar,15000000,47811275,52461017,37461017,True
3023,24,1997-08-15,cop land,15000000,44906632,63706632,48706632,True
3024,25,1997-12-25,wag the dog,15000000,43057470,64252038,49252038,True
3025,26,2013-02-22,snitch,15000000,42930462,57907734,42907734,True
3026,27,2003-05-02,the lizzie mcguire movie,15000000,42734455,55534455,40534455,True
3027,28,2015-12-04,krampus,15000000,42725475,61788393,46788393,True
3028,29,2012-09-21,end of watch,15000000,41003371,57586606,42586606,True
3029,30,1998-12-25,the faculty,15000000,40283321,40283321,25283321,True
3030,31,1993-06-09,what's love got to do with it,15000000,39100956,39100956,24100956,True
3031,32,2001-12-14,not another teen movie,15000000,37882551,62401343,47401343,True
3032,33,2014-12-03,wild,15000000,37880356,52460543,37460543,True
3033,34,1962-12-16,lawrence of arabia,15000000,37495385,69995385,54995385,True
3034,35,2014-11-07,the theory of everything,15000000,35893537,123327692,108327692,True
3035,36,2011-09-16,drive,15000000,35060689,81357930,66357930,True
3036,37,2000-03-31,the skulls,15000000,35007180,35007180,20007180,True
3037,38,1966-10-10,hawaii,15000000,34562222,34562222,19562222,True
3038,39,2018-11-23,the favourite,15000000,34366783,94113929,79113929,True
3039,40,2003-04-18,malibu's most wanted,15000000,34308901,34499204,19499204,True
3040,41,2009-09-04,all about steve,15000000,33862903,40127259,25127259,True
3041,42,2000-04-28,where the heart is,15000000,33771174,40862054,25862054,True
3042,43,2009-08-28,halloween 2,15000000,33392973,38512850,23512850,True
3043,44,2009-03-13,the last house on the left,15000000,32752215,46526243,31526243,True
3044,45,2005-02-18,because of winn-dixie,15000000,32647042,33508485,18508485,True
3045,46,2005-02-04,the wedding date,15000000,31726995,47175038,32175038,True
3046,47,1987-09-25,the princess bride,15000000,30857000,30859628,15859628,True
3047,48,2002-07-12,halloween: resurrection,15000000,30259652,37659652,22659652,True
3048,49,2007-12-25,the great debaters,15000000,30226144,30261293,15261293,True
3049,50,2014-08-22,when the game stands tall,15000000,30127963,30138912,15138912,True
3050,51,1981-06-12,clash of the titans,15000000,30000000,44400000,29400000,True
3051,52,2004-02-20,confessions of a teenage drama queen,15000000,29331068,33118854,18118854,True
3052,53,1998-04-17,the object of my affection,15000000,29145924,29145924,14145924,True
3053,54,2007-05-11,28 weeks later,15000000,28638916,64232714,49232714,True
3054,55,1997-04-11,grosse pointe blank,15000000,28084357,31070412,16070412,True
3055,56,2000-04-21,love and basketball,15000000,27441122,27709625,12709625,True
3056,57,2017-09-08,home again,15000000,27020284,37336874,22336874,True
3057,58,2000-10-27,book of shadows: blair witch 2,15000000,26421314,47721314,32721314,True
3058,59,1997-10-10,boogie nights,15000000,26410771,43111725,28111725,True
3059,60,2010-07-23,ramona and beezus,15000000,26167002,27469621,12469621,True
3060,61,2014-08-27,the november man,15000000,25018119,34820335,19820335,True
3061,62,1996-05-03,the craft,15000000,24769466,55669466,40669466,True
3062,63,2005-12-28,match point,15000000,23089926,87973835,72973835,True
3063,64,1993-11-05,the remains of the day,15000000,22954968,63954968,48954968,True
3064,65,1993-01-15,nowhere to run,15000000,22189039,52189039,37189039,True
3065,66,2000-09-22,urban legends: final cut,15000000,21468807,38574362,23574362,True
3066,67,2013-03-29,the place beyond the pines,15000000,21403519,47011449,32011449,True
3067,68,2006-10-20,flicka,15000000,21000147,21896367,6896367,True
3068,69,2007-03-23,the hills have eyes ii,15000000,20804166,37466538,22466538,True
3069,70,2016-04-29,keanu,15000000,20591853,20688141,5688141,True
3070,71,2010-12-22,country strong,15000000,20218921,20601987,5601987,True
3071,72,2002-10-11,tuck everlasting,15000000,19161999,19344615,4344615,True
3072,73,2006-10-13,the marine,15000000,18844784,22165608,7165608,True
3073,74,1998-07-24,disturbing behavior,15000000,17507368,19014238,4014238,True
3074,75,1998-03-06,the big lebowski,15000000,17498804,46189568,31189568,True
3075,76,2014-07-25,a most wanted man,15000000,17237855,36068890,21068890,True
3076,77,2009-06-26,the hurt locker,15000000,17017811,49894223,34894223,True
3077,78,2000-01-28,eye of the beholder,15000000,16500786,18260865,3260865,True
3078,79,2012-11-02,the man with the iron fists,15000000,15634090,22018988,7018988,True
3079,80,1984-05-11,firestarter,15000000,15136870,15136870,136870,True
3080,81,2019-02-01,miss bala,15000000,14998027,15362298,362298,False
3081,82,2012-11-30,killing them softly,15000000,14945541,39238443,24238443,False
3082,83,2001-04-20,freddy got fingered,15000000,14249005,14249005,-750995,False
3083,84,2011-08-19,one day,15000000,13843771,59168692,44168692,False
3084,85,2004-06-25,de-lovely,15000000,13337299,18524496,3524496,False
3085,86,2009-10-02,whip it,15000000,13077184,18889972,3889972,False
3086,87,2008-01-11,the pirates who don't do anything: a veggietales movie,15000000,12981269,13248444,-1751556,False
3087,88,2008-01-23,u2 3d,15000000,12898847,26170402,11170402,False
3088,89,2000-09-01,highlander: endgame,15000000,12801190,12801190,-2198810,False
3089,90,2017-01-20,the founder,15000000,12786053,24403192,9403192,False
3090,91,2006-08-25,idlewild,15000000,12669914,12669914,-2330086,False
3091,92,2003-04-25,confidence,15000000,12212417,12212417,-2787583,False
3092,93,2002-10-11,knockaround guys,15000000,11660180,12419700,-2580300,False
3093,94,1999-08-27,the muse,15000000,11614954,11614954,-3385046,False
3094,95,1998-04-03,barney's great adventure,15000000,11156471,11156471,-3843529,False
3095,96,1989-03-01,new york stories,15000000,10763469,10763469,-4236531,False
3096,97,1998-11-25,home fries,15000000,10513979,10513979,-4486021,False
3097,98,2000-03-24,here on earth,15000000,10494147,10845127,-4154873,False
3098,99,2004-10-08,raise your voice,15000000,10411980,14811980,-188020,False
3099,100,1985-12-18,brazil,15000000,9929135,9932146,-5067854,False
3100,1,1993-04-23,the dark half,15000000,9579068,9579068,-5420932,False
3101,2,2007-03-02,black snake moan,15000000,9396870,10951153,-4048847,False
3102,3,2003-02-21,dark blue,15000000,9237470,12262065,-2737935,False
3103,4,2007-06-22,a mighty heart,15000000,9176787,19153568,4153568,False
3104,5,1983-09-30,brainstorm,15000000,8921050,8921050,-6078950,False
3105,6,2016-09-23,queen of katwe,15000000,8874389,10055481,-4944519,False
3106,7,2000-03-24,whatever it takes,15000000,8735529,8735529,-6264471,False
3107,8,2003-03-21,boat trip,15000000,8586376,14933713,-66287,False
3108,9,2002-05-22,the importance of being earnest,15000000,8378141,8378141,-6621859,False
3109,10,1999-05-21,the love letter,15000000,8322608,9010980,-5989020,False
3110,11,2006-05-05,hoot,15000000,8117637,8224998,-6775002,False
3111,12,2008-02-08,in bruges,15000000,7800825,34533783,19533783,False
3112,13,2013-01-04,promised land,15000000,7597898,12394562,-2605438,False
3113,14,2001-10-08,mulholland drive,15000000,7219578,20785973,5785973,False
3114,15,2018-06-08,hotel artemis,15000000,6708137,12758799,-2241201,False
3115,16,2008-08-20,the rocker,15000000,6409528,8767338,-6232662,False
3116,17,2009-08-21,post grad,15000000,6382178,6563402,-8436598,False
3117,18,2009-06-19,whatever works,15000000,5306706,35106706,20106706,False
3118,19,2000-07-19,the in crowd,15000000,5217498,5217498,-9782502,False
3119,20,2005-12-14,los tres entierros de melquiades estrada,15000000,5027684,13454474,-1545526,False
3120,21,1999-09-24,jakob the liar,15000000,4956401,4956401,-10043599,False
3121,22,2007-09-28,se jie,15000000,4604982,65167430,50167430,False
3122,23,2005-10-21,"kiss kiss, bang bang",15000000,4235837,16829464,1829464,False
3123,24,1999-04-30,idle hands,15000000,4023741,4023741,-10976259,False
3124,25,2015-10-30,scouts guide to the zombie apocalypse,15000000,3703046,15554855,554855,False
3125,26,2007-01-26,blood and chocolate,15000000,3526588,6551310,-8448690,False
3126,27,2010-09-22,you will meet a tall dark stranger,15000000,3247816,34247816,19247816,False
3127,28,2015-10-23,rock the kasbah,15000000,3020665,3386153,-11613847,False
3128,29,2010-09-15,never let me go,15000000,2434652,11173718,-3826282,False
3129,30,2016-09-09,the disappointments room,15000000,2423467,3503761,-11496239,False
3130,31,2003-12-25,the company,15000000,2281585,3396508,-11603492,False
3131,32,2008-07-18,transsiberian,15000000,2203641,6379575,-8620425,False
3132,33,1999-10-22,crazy in alabama,15000000,1954202,1954202,-13045798,False
3133,34,1986-01-17,the clan of the cave bear,15000000,1953732,1953732,-13046268,False
3134,35,2017-02-03,the comedian,15000000,1658706,1658706,-13341294,False
3135,36,2008-03-14,funny games,15000000,1294640,8200127,-6799873,False
3136,37,2006-06-02,banlieue 13,15000000,1200216,11599903,-3400097,False
3137,38,1999-11-12,felicia's journey,15000000,824295,1970268,-13029732,False
3138,39,2002-01-25,metropolis,15000000,673414,1405032,-13594968,False
3139,40,2015-10-16,cã¬kã¨ niã¨ yinniã¡ng,15000000,632542,11279884,-3720116,False
3140,41,1995-12-01,things to do in denver when you're dead,15000000,529766,529766,-14470234,False
3141,42,2013-04-26,the reluctant fundamentalist,15000000,528731,528731,-14471269,False
3142,43,2004-02-06,the return,15000000,501752,5953886,-9046114,False
3143,44,2003-07-25,buffalo soldiers,15000000,353743,353743,-14646257,False
3144,45,2003-04-25,steal (canadian release),15000000,220944,220944,-14779056,False
3145,46,2010-08-27,centurion,15000000,123570,7885048,-7114952,False
3146,47,2009-10-23,ong-bak 2,15000000,102458,7583050,-7416950,False
3147,48,1996-12-31,silent trigger,15000000,76382,76382,-14923618,False
3148,49,2008-08-01,midnight meat train,15000000,73548,1590246,-13409754,False
3149,50,2013-09-06,winnie mandela,15000000,61847,61847,-14938153,False
3150,51,2011-11-04,the son of no one,15000000,30680,1148578,-13851422,False
3151,52,2002-10-25,all the queen's men,15000000,22723,22723,-14977277,False
3152,53,2007-10-05,the good night,15000000,22441,22441,-14977559,False
3153,54,2013-12-06,khumba,15000000,0,20898221,5898221,False
3154,55,2015-05-05,a few best men,15000000,0,17224539,2224539,False
3155,56,2014-10-10,autã³mata,15000000,0,6775458,-8224542,False
3156,57,2015-12-31,chiamatemi francesco - il papa della gente,15000000,0,3925769,-11074231,False
3157,58,2008-12-31,bathory,15000000,0,3436763,-11563237,False
3158,59,2010-02-05,san suk si gin,15000000,0,2013340,-12986660,False
3159,60,2005-12-31,dungeons & dragons: wrath of the dragon god,15000000,0,909822,-14090178,False
3160,61,2017-02-17,in dubious battle,15000000,0,214182,-14785818,False
3161,62,2015-09-01,broken horses,15000000,0,3471,-14996529,False
3162,63,2001-06-29,pandaemonium,15000000,0,0,-15000000,False
3163,64,2019-08-14,blinded by the light,15000000,0,0,-15000000,False
3164,65,1993-02-12,groundhog day,14600000,70906973,70906973,56306973,True
3165,66,2015-07-01,magic mike xxl,14500000,66013057,123660597,109160597,True
3166,67,1996-11-01,romeo+juliet,14500000,46338728,147542381,133042381,True
3167,68,2011-07-22,elle s'appelait sarah,14500000,7691700,25480031,10980031,False
3168,69,2015-06-05,freedom,14500000,0,872757,-13627243,False
3169,70,1992-08-07,unforgiven,14400000,101157447,159157447,144757447,True
3170,71,2006-01-27,manderlay,14200000,74205,543306,-13656694,False
3171,72,1990-03-23,pretty woman,14000000,178406268,432645872,418645872,True
3172,73,1987-09-18,fatal attraction,14000000,156645693,320100000,306100000,True
3173,74,2008-11-12,slumdog millionaire,14000000,141330703,384530440,370530440,True
3174,75,1974-12-17,towering inferno,14000000,116000000,139700000,125700000,True
3175,76,1988-05-25,crocodile dundee 2,14000000,109306210,239606210,225606210,True
3176,77,1989-12-20,born on the fourth of july,14000000,70001698,70001698,56001698,True
3177,78,1993-10-01,cool runnings,14000000,68856263,155056263,141056263,True
3178,79,2007-01-12,stomp the yard,14000000,61356221,75525718,61525718,True
3179,80,2009-01-16,my bloody valentine,14000000,51545952,102836002,88836002,True
3180,81,2012-08-31,the possession,14000000,49130588,82925064,68925064,True
3181,82,1982-10-22,first blood,14000000,47212904,125212904,111212904,True
3182,83,1977-07-13,the spy who loved me,14000000,46800000,185400000,171400000,True
3183,84,1998-09-25,urban legend,14000000,38116707,72571864,58571864,True
3184,85,1981-12-09,taps,14000000,35856053,35856053,21856053,True
3185,86,2012-02-24,tyler perry's good deeds,14000000,35025791,35579177,21579177,True
3186,87,1991-01-18,white fang,14000000,34729091,34729091,20729091,True
3187,88,1988-12-21,dangerous liaisons,14000000,34700000,34700000,20700000,True
3188,89,1999-10-08,superstar,14000000,30628981,30628981,16628981,True
3189,90,2012-01-13,the iron lady,14000000,29959436,115592104,101592104,True
3190,91,1993-07-23,poetic justice,14000000,27450453,27450453,13450453,True
3191,92,2002-10-04,jonah: a veggietales movie,14000000,25571351,25608779,11608779,True
3192,93,2002-03-08,all about the benjamins,14000000,25482931,25873145,11873145,True
3193,94,1977-06-17,exorcist ii: the heretic,14000000,25011000,25011000,11011000,True
3194,95,2010-03-12,our family wedding,14000000,20255281,21410546,7410546,True
3195,96,1995-10-27,vampire in brooklyn,14000000,19637147,19637147,5637147,True
3196,97,2006-05-05,an american haunting,14000000,16298046,30443277,16443277,True
3197,98,2003-08-22,my boss's daughter,14000000,15549702,15549702,1549702,True
3198,99,2009-08-07,a perfect getaway,14000000,15515460,22815460,8815460,True
3199,100,1996-10-25,thinner,14000000,15171475,15171475,1171475,True
3200,1,1998-08-21,dead man on campus,14000000,15064948,15064948,1064948,True
3201,2,1999-05-14,tea with mussolini,14000000,14395874,14395874,395874,True
3202,3,1977-06-22,"new york, new york",14000000,13800000,13800000,-200000,False
3203,4,2002-04-26,jason x,14000000,13121555,16951798,2951798,False
3204,5,1994-05-13,crooklyn,14000000,13024170,13024170,-975830,False
3205,6,2007-03-16,i think i love my wife,14000000,12559771,13205411,-794589,False
3206,7,2015-02-20,hot tub time machine 2,14000000,12314651,12826644,-1173356,False
3207,8,2006-11-17,bobby,14000000,11242801,20597806,6597806,False
3208,9,2001-02-02,head over heels,14000000,10397365,10397365,-3602635,False
3209,10,2012-10-26,fun size,14000000,9409538,11166615,-2833385,False
3210,11,1999-04-23,lost and found,14000000,6552255,6552255,-7447745,False
3211,12,2007-11-30,le scaphandre et le papillon,14000000,5990075,22754472,8754472,False
3212,13,2006-10-06,little children,14000000,5463019,14121177,121177,False
3213,14,2000-04-21,gossip,14000000,5108820,12591270,-1408730,False
3214,15,1999-03-26,a walk on the moon,14000000,4741987,4741987,-9258013,False
3215,16,2015-10-23,suffragette,14000000,4702420,34044909,20044909,False
3216,17,2006-10-27,catch a fire,14000000,4299773,5782198,-8217802,False
3217,18,2014-12-19,mr. turner,14000000,3958546,25187026,11187026,False
3218,19,2001-09-07,soul survivors,14000000,3100650,4288246,-9711754,False
3219,20,2009-05-22,easy virtue,14000000,2656784,20537741,6537741,False
3220,21,1995-03-31,jefferson in paris,14000000,2461628,2461628,-11538372,False
3221,22,2010-08-06,flipped,14000000,1755212,4289993,-9710007,False
3222,23,1978-01-01,caravans,14000000,1000000,1000000,-13000000,False
3223,24,2010-06-25,les herbes folles,14000000,403952,1903952,-12096048,False
3224,25,2003-01-24,amen,14000000,274299,274299,-13725701,False
3225,26,2008-09-26,the lucky ones,14000000,266967,266967,-13733033,False
3226,27,2011-09-30,margaret,14000000,47185,623292,-13376708,False
3227,28,2016-11-01,reign of assassins,14000000,0,11354230,-2645770,False
3228,29,2009-10-27,stan helsing: a parody,14000000,0,1553556,-12446444,False
3229,30,2005-12-09,brokeback mountain,13900000,83043761,176980863,163080863,True
3230,31,1995-07-01,clueless,13700000,56598476,56598476,42898476,True
3231,32,2008-12-31,ca$h,13700000,0,11738256,-1961744,False
3232,33,1990-03-30,teenage mutant ninja turtles,13500000,135265915,202000000,188500000,True
3233,34,1956-10-05,the ten commandments,13500000,85400591,85434516,71934516,True
3234,35,2002-11-08,far from heaven,13500000,15901849,29027914,15527914,True
3235,36,2012-10-12,seven psychopaths,13500000,15024049,33035736,19535736,True
3236,37,2000-11-22,quills,13500000,7060876,11732088,-1767912,False
3237,38,1982-01-29,the border,13500000,6118683,6118683,-7381317,False
3238,39,2005-02-18,der untergang,13500000,5501940,93631744,80131744,False
3239,40,2001-03-02,the caveman's valentine,13500000,687081,892506,-12607494,False
3240,41,2011-04-01,the last godfather,13400000,164247,164247,-13235753,False
3241,42,2014-04-04,under the skin,13300000,2614251,7229933,-6070067,False
3242,43,2004-12-17,mar adentro,13300000,2086345,39686345,26386345,False
3243,44,2014-09-12,no good deed,13200000,52543632,54323210,41123210,True
3244,45,1987-12-23,good morning vietnam,13000000,123922370,123922370,110922370,True
3245,46,2010-12-03,black swan,13000000,106954678,331266710,318266710,True
3246,47,2001-01-12,save the last dance,13000000,91038276,122244329,109244329,True
3247,48,2011-02-11,justin bieber: never say never,13000000,73013910,99034125,86034125,True
3248,49,2018-07-04,the first purge,13000000,69488745,136617305,123617305,True
3249,50,2016-03-16,miracles from heaven,13000000,61705123,73798736,60798736,True
3250,51,2000-02-11,snow day,13000000,60008303,62452927,49452927,True
3251,52,2004-01-23,the butterfly effect,13000000,57924679,95638592,82638592,True
3252,53,1974-12-11,the godfather: part ii,13000000,57300000,57300000,44300000,True
3253,54,2016-06-24,the shallows,13000000,55121623,118763442,105763442,True
3254,55,1987-07-17,robocop,13000000,53424681,53424681,40424681,True
3255,56,1988-08-19,a nightmare on elm street 4: the dream master,13000000,49369899,49369899,36369899,True
3256,57,2007-11-21,this christmas,13000000,49121934,49733545,36733545,True
3257,58,2014-02-14,about last night,13000000,48637684,50445860,37445860,True
3258,59,2000-12-15,"dude, where's my car?",13000000,46729374,73180297,60180297,True
3259,60,1988-08-12,young guns,13000000,44726644,44726644,31726644,True
3260,61,2014-10-10,st. vincent,13000000,44137712,54837234,41837234,True
3261,62,2014-07-02,earth to echo,13000000,38934842,42174545,29174545,True
3262,63,1999-03-31,10 things i hate about you,13000000,38177966,60413950,47413950,True
3263,64,2002-05-10,the new guy,13000000,28972187,28972187,15972187,True
3264,65,1993-02-05,loaded weapon 1,13000000,27979399,27979399,14979399,True
3265,66,1999-03-12,baby geniuses,13000000,27151490,27151490,14151490,True
3266,67,1998-04-24,the big hit,13000000,27066941,27066941,14066941,True
3267,68,1990-11-09,child's play 2,13000000,26904572,34166572,21166572,True
3268,69,1996-07-10,harriet the spy,13000000,26570048,26570048,13570048,True
3269,70,2013-03-01,21 and over,13000000,25682380,42195766,29195766,True
3270,71,2007-11-21,the mist,13000000,25593755,57189408,44189408,True
3271,72,2015-04-10,ex machina,13000000,25440971,38358392,25358392,True
3272,73,1999-10-29,being john malkovich,13000000,22858926,32382381,19382381,True
3273,74,2001-09-07,two can play that game,13000000,22235901,22391450,9391450,True
3274,75,2016-03-11,eye in the sky,13000000,18704596,35402802,22402802,True
3275,76,2013-03-22,admission,13000000,18007317,18733666,5733666,True
3276,77,2012-09-21,the perks of being a wallflower,13000000,17742948,33069303,20069303,True
3277,78,2001-06-29,crazy/beautiful,13000000,16929123,19929123,6929123,True
3278,79,1998-08-28,54,13000000,16757163,16757163,3757163,True
3279,80,2015-10-16,room,13000000,14677674,36262783,23262783,True
3280,81,2015-10-16,woodlawn,13000000,14394097,14403703,1403703,True
3281,82,2006-12-20,letters from iwo jima,13000000,13756082,67867998,54867998,True
3282,83,2009-05-29,mã¤n som hatar kvinnor,13000000,12749992,109421911,96421911,False
3283,84,2007-02-23,the astronaut farmer,13000000,11003643,11141213,-1858787,False
3284,85,1998-06-12,dirty work,13000000,10020081,10020081,-2979919,False
3285,86,2015-07-17,bajrangi bhaijaan,13000000,8178001,121778347,108778347,False
3286,87,1998-05-08,woo,13000000,8064972,8064972,-4935028,False
3287,88,2016-09-09,robinson crusoe,13000000,8005586,42446455,29446455,False
3288,89,1994-04-13,serial mom,13000000,7881335,7881335,-5118665,False
3289,90,1999-08-04,dick,13000000,6276869,6276869,-6723131,False
3290,91,1999-11-10,light it up,13000000,5871603,5871603,-7128397,False
3291,92,2001-08-24,bubble boy,13000000,5002310,5002310,-7997690,False
3292,93,2002-02-01,birthday girl,13000000,4919896,8130727,-4869273,False
3293,94,2007-05-04,"paris, je t'aime",13000000,4857374,5175088,-7824912,False
3294,95,2018-12-07,ben is back,13000000,3703182,9633111,-3366889,False
3295,96,2007-08-24,resurrecting the champ,13000000,3172382,3260555,-9739445,False
3296,97,2010-03-26,chloe,13000000,3075255,11831131,-1168869,False
3297,98,2001-03-02,the widow of st. pierre,13000000,3058380,3058380,-9941620,False
3298,99,2015-12-04,youth,13000000,2703296,24001573,11001573,False
3299,100,1996-04-05,faithful,13000000,2104439,2104439,-10895561,False
3300,1,2010-02-26,un prophã¨te,13000000,2087720,19910624,6910624,False
3301,2,2010-12-03,"i love you, phillip morris",13000000,2037459,23014027,10014027,False
3302,3,2015-07-24,the vatican tapes,13000000,1784763,14929184,1929184,False
3303,4,2006-03-17,find me guilty,13000000,1173673,2898225,-10101775,False
3304,5,1993-05-14,excessive force,13000000,1152117,1152117,-11847883,False
3305,6,2006-10-13,infamous,13000000,1151330,2613717,-10386283,False
3306,7,2011-07-29,attack the block,13000000,1024175,6459183,-6540817,False
3307,8,2015-08-14,brothers,13000000,656688,17856688,4856688,False
3308,9,2000-12-29,the claim,13000000,622023,1375635,-11624365,False
3309,10,2011-12-23,in the land of blood and honey,13000000,303877,509193,-12490807,False
3310,11,2010-06-18,the killer inside me,13000000,217277,3617277,-9382723,False
3311,12,2012-03-30,womb,13000000,0,0,-13000000,False
3312,13,2019-12-31,rogue city,13000000,0,0,-13000000,False
3313,14,2013-03-15,the call,12800000,51872378,69821476,57021476,True
3314,15,2016-08-05,operation chromite,12700000,1022720,49196532,36496532,False
3315,16,2014-09-12,the drop,12600000,10724389,19054534,6454534,False
3316,17,2002-07-12,the crocodile hunter: collision course,12500000,28436931,33436931,20936931,True
3317,18,2010-09-03,machete,12500000,26593646,46370970,33870970,True
3318,19,2002-12-19,antwone fisher,12500000,21078145,23367586,10867586,True
3319,20,1982-02-12,la guerre du feu,12500000,20959585,20959585,8459585,True
3320,21,2002-11-22,the emperor's club,12500000,14060950,16193713,3693713,True
3321,22,1993-09-10,true romance,12500000,12281000,12309980,-190020,False
3322,23,2009-09-11,sorority row,12500000,11965282,26735797,14235797,False
3323,24,1992-09-30,glengarry glen ross,12500000,10725228,10725228,-1774772,False
3324,25,2008-11-07,the boy in the striped pyjamas,12500000,9046156,44083403,31583403,False
3325,26,1982-04-02,cat people,12500000,7000000,21000000,8500000,False
3326,27,1979-05-25,the prisoner of zenda,12500000,7000000,7000000,-5500000,False
3327,28,2010-10-15,conviction,12500000,6797696,11826980,-673020,False
3328,29,2007-10-12,lars and the real girl,12500000,5956480,11277119,-1222881,False
3329,30,2010-05-21,solitary man,12500000,4360548,4360548,-8139452,False
3330,31,2000-09-22,dancer in the dark,12500000,4157491,45557491,33057491,False
3331,32,2010-12-17,casino jack,12500000,2039869,2272186,-10227814,False
3332,33,1997-12-31,oscar and lucinda,12500000,1612957,1612957,-10887043,False
3333,34,1996-11-01,the funeral,12500000,1212799,1412799,-11087201,False
3334,35,2004-09-03,tae guik gi: the brotherhood of war,12500000,1110186,69826708,57326708,False
3335,36,2010-04-16,the perfect game,12500000,1089445,3931367,-8568633,False
3336,37,2012-10-05,the paperboy,12500000,677200,4027663,-8472337,False
3337,38,2013-03-01,ernest et celestine,12500000,292562,9376444,-3123556,False
3338,39,2012-05-04,a little bit of heaven,12500000,10011,1100287,-11399713,False
3339,40,1988-11-18,the land before time,12300000,48092846,81972846,69672846,True
3340,41,1975-06-20,jaws,12000000,260000000,470700000,458700000,True
3341,42,1973-12-26,the exorcist,12000000,230347346,428214478,416214478,True
3342,43,2014-06-06,the fault in our stars,12000000,124872350,307166834,295166834,True
3343,44,1999-07-09,american pie,12000000,101800948,234723148,222723148,True
3344,45,2012-04-20,think like a man,12000000,91547205,113373764,101373764,True
3345,46,2014-04-16,heaven is for real,12000000,91386097,100916299,88916299,True
3346,47,1986-12-12,the golden child,12000000,79817937,79817937,67817937,True
3347,48,1982-06-04,star trek ii: the wrath of khan,12000000,78912963,95800000,83800000,True
3348,49,2002-09-13,barbershop,12000000,75781642,77063461,65063461,True
3349,50,1983-06-03,wargames,12000000,74433837,74433837,62433837,True
3350,51,1994-02-04,ace ventura: pet detective,12000000,72217396,107217396,95217396,True
3351,52,2012-02-24,act of valor,12000000,70012847,82497035,70497035,True
3352,53,1985-02-08,witness,12000000,65532576,65532576,53532576,True
3353,54,2006-08-11,step up,12000000,65328121,110989157,98989157,True
3354,55,2012-02-03,chronicle,12000000,64575175,123681790,111681790,True
3355,56,1996-12-20,beavis and butt-head do america,12000000,63118386,63118386,51118386,True
3356,57,1970-01-01,patton,12000000,62500000,62500000,50500000,True
3357,58,2012-03-02,project x,12000000,54731865,103028188,91028188,True
3358,59,2017-11-10,"three billboards outside ebbing, missouri",12000000,54513740,160191915,148191915,True
3359,60,2016-11-25,lion,12000000,51739495,149570720,137570720,True
3360,61,2018-05-04,overboard,12000000,50316123,85369830,73369830,True
3361,62,1997-12-25,jackie brown,12000000,39673162,74727492,62727492,True
3362,63,1983-11-18,yentl,12000000,39012241,39012241,27012241,True
3363,64,2008-04-25,harold & kumar escape from guantanamo bay,12000000,38108728,43353117,31353117,True
3364,65,2013-11-22,philomena,12000000,37709979,98963392,86963392,True
3365,66,1981-11-06,time bandits,12000000,37400000,37400000,25400000,True
3366,67,2002-02-15,crossroads,12000000,37188667,57000000,45000000,True
3367,68,2015-07-24,paper towns,12000000,32000304,85450484,73450484,True
3368,69,2008-10-10,quarantine,12000000,31691811,41924774,29924774,True
3369,70,2002-08-21,one hour photo,12000000,31597131,52223306,40223306,True
3370,71,2008-02-01,the eye,12000000,31418697,57577765,45577765,True
3371,72,2004-04-07,johnson family vacation,12000000,31203964,31286759,19286759,True
3372,73,2001-12-21,how high,12000000,31155435,31222395,19222395,True
3373,74,1960-10-07,spartacus,12000000,30000000,60000000,48000000,True
3374,75,2006-09-01,crank,12000000,27838408,43924923,31924923,True
3375,76,1992-12-11,the muppet christmas carol,12000000,27281507,27492918,15492918,True
3376,77,2016-08-12,hell or high water,12000000,27007844,37584304,25584304,True
3377,78,2002-10-25,frida,12000000,25885000,56131239,44131239,True
3378,79,2012-07-05,katy perry: part of me,12000000,25326071,32700439,20700439,True
3379,80,2014-12-12,top five,12000000,25317379,26001741,14001741,True
3380,81,1998-09-11,rounders,12000000,22921898,22921898,10921898,True
3381,82,1967-04-28,casino royale,12000000,22744718,41744718,29744718,True
3382,83,1979-06-15,prophecy,12000000,22673340,22673340,10673340,True
3383,84,2015-01-30,project almanac,12000000,22348241,32909437,20909437,True
3384,85,2010-05-14,just wright,12000000,21540363,21867665,9867665,True
3385,86,1999-09-10,stir of echoes,12000000,21133087,21133087,9133087,True
3386,87,1995-01-13,tales from the crypt: demon knight,12000000,21089146,21089146,9089146,True
3387,88,1978-01-01,the boys from brazil,12000000,19000000,19000000,7000000,True
3388,89,2005-03-11,the upside of anger,12000000,18761993,28915761,16915761,True
3389,90,2006-03-03,aquamarine,12000000,18597342,22978953,10978953,True
3390,91,2013-11-15,nebraska,12000000,17654912,24761360,12761360,True
3391,92,2004-01-09,my baby's daddy,12000000,17321573,17322212,5322212,True
3392,93,2001-10-05,max keeble's big move,12000000,17292381,17292381,5292381,True
3393,94,2011-12-09,young adult,12000000,16311571,22750356,10750356,True
3394,95,2013-11-01,about time,12000000,15323921,89309178,77309178,True
3395,96,2018-12-14,if beale street could talk,12000000,14915773,19859167,7859167,True
3396,97,2017-07-14,wish upon,12000000,14301505,23477345,11477345,True
3397,98,1997-08-06,def jam's how to be a player,12000000,14010363,14010363,2010363,True
3398,99,1998-10-30,living out loud,12000000,12905901,12905901,905901,True
3399,100,2008-10-03,rachel getting married,12000000,12796861,17475475,5475475,True
3400,1,1981-03-20,the postman always rings twice,12000000,12200000,44200000,32200000,True
3401,2,2003-12-12,girl with a pearl earring,12000000,11634362,43274797,31274797,False
3402,3,1982-02-10,das boot,12000000,11487676,84970337,72970337,False
3403,4,2017-04-21,unforgettable,12000000,11368012,16221211,4221211,False
3404,5,2004-12-03,house of flying daggers,12000000,11050094,92863945,80863945,False
3405,6,2002-03-22,sorority boys,12000000,10198766,12516222,516222,False
3406,7,2017-10-13,marshall,12000000,10051659,10116816,-1883184,False
3407,8,2008-12-05,cadillac records,12000000,8195551,8942516,-3057484,False
3408,9,2012-09-14,arbitrage,12000000,7919574,35830713,23830713,False
3409,10,1960-10-24,the alamo,12000000,7900000,7900000,-4100000,False
3410,11,2000-05-12,screwed,12000000,6982680,6982680,-5017320,False
3411,12,2006-10-20,running with scissors,12000000,6860000,8706701,-3293299,False
3412,13,1993-09-03,fortress,12000000,6730578,46730578,34730578,False
3413,14,2012-06-01,for greater glory: the true story of cristiada,12000000,5669081,10026255,-1973745,False
3414,15,2006-11-17,for your consideration,12000000,5549923,5549923,-6450077,False
3415,16,1998-11-20,celebrity,12000000,5078660,6200000,-5800000,False
3416,17,2003-06-20,from justin to kelly,12000000,4922166,4922166,-7077834,False
3417,18,1986-06-06,invaders from mars,12000000,4884663,4984663,-7015337,False
3418,19,1996-03-22,girl 6,12000000,4880941,4880941,-7119059,False
3419,20,2003-10-22,in the cut,12000000,4717455,23693646,11693646,False
3420,21,2008-02-22,charlie bartlett,12000000,3950294,5295909,-6704091,False
3421,22,2009-02-13,two lovers,12000000,3149034,16349034,4349034,False
3422,23,2013-11-15,la grande bellezza,12000000,2883879,29549145,17549145,False
3423,24,2002-02-15,last orders,12000000,2326407,2326407,-9673593,False
3424,25,2007-03-09,gwoemul,12000000,2201923,92618117,80618117,False
3425,26,1981-11-13,the pursuit of d.b. cooper,12000000,2104164,2104164,-9895836,False
3426,27,1999-03-19,ravenous,12000000,2062406,2062406,-9937594,False
3427,28,2002-06-14,the dangerous lives of altar boys,12000000,1779284,1779284,-10220716,False
3428,29,2013-03-01,stoker,12000000,1703125,12034913,34913,False
3429,30,2008-03-07,married life,12000000,1506998,2975188,-9024812,False
3430,31,2005-08-05,2046,12000000,1442338,19287485,7287485,False
3431,32,2011-03-11,kill the irishman,12000000,1188194,1188194,-10811806,False
3432,33,2005-09-30,duma,12000000,870067,994790,-11005210,False
3433,34,2012-04-20,darling companion,12000000,793352,1200346,-10799654,False
3434,35,2010-06-04,ondine,12000000,550472,557545,-11442455,False
3435,36,2001-07-20,brother,12000000,450594,450594,-11549406,False
3436,37,2002-10-04,welcome to collinwood,12000000,378650,4606284,-7393716,False
3437,38,2008-04-18,life before her eyes,12000000,303439,7203439,-4796561,False
3438,39,1997-10-31,critical care,12000000,220175,220175,-11779825,False
3439,40,2007-09-28,trade,12000000,214202,1513388,-10486612,False
3440,41,2006-01-06,fateless,12000000,196857,196857,-11803143,False
3441,42,2010-09-03,san qiang pai an jing qi,12000000,190946,310946,-11689054,False
3442,43,1999-09-17,breakfast of champions,12000000,178287,178287,-11821713,False
3443,44,2001-03-09,company man,12000000,146028,622273,-11377727,False
3444,45,2009-11-07,nanjing! nanjing!,12000000,122558,20122558,8122558,False
3445,46,2015-10-09,trash,12000000,17484,6553186,-5446814,False
3446,47,2011-08-19,5 days of war,12000000,17479,87793,-11912207,False
3447,48,2015-11-11,10 days in a madhouse,12000000,14616,14616,-11985384,False
3448,49,2009-04-07,1612,12000000,0,5400624,-6599376,False
3449,50,2015-12-31,san cheng ji,12000000,0,1950194,-10049806,False
3450,51,2011-12-31,tu xia chuan qi,12000000,0,1828400,-10171600,False
3451,52,2010-02-10,triangle,12000000,0,1594955,-10405045,False
3452,53,2013-10-19,supesu batorushippu yamato,12000000,0,0,-12000000,False
3453,54,2014-10-03,drive hard,12000000,0,0,-12000000,False
3454,55,2015-10-30,dancin' it's on,12000000,0,0,-12000000,False
3455,56,2009-06-05,home,12000000,0,0,-12000000,False
3456,57,2016-09-23,the dressmaker,11900000,2022115,24041617,12141617,False
3457,58,1999-12-10,diamonds,11900000,81897,81897,-11818103,False
3458,59,1998-03-20,madadayo,11900000,48856,48856,-11851144,False
3459,60,2015-11-20,carol,11800000,12711491,42843521,31043521,True
3460,61,1989-04-21,pet sematary,11500000,57469179,57469179,45969179,True
3461,62,2016-01-22,dirty grandpa,11500000,35593113,105078449,93578449,True
3462,63,2009-11-27,the cry of the owl,11500000,0,0,-11500000,False
3463,64,2009-10-09,st. trinianâs,11400000,15000,29830239,18430239,False
3464,65,1977-05-25,star wars ep. iv: a new hope,11000000,460998007,786598007,775598007,True
3465,66,1984-06-08,gremlins,11000000,148168459,148199515,137199515,True
3466,67,1965-12-22,doctor zhivago,11000000,111897830,112036323,101036323,True
3467,68,2010-12-10,the fighter,11000000,93617009,129262388,118262388,True
3468,69,2008-10-24,high school musical 3: senior year,11000000,90559416,274392880,263392880,True
3469,70,1991-12-27,fried green tomatoes,11000000,81204830,81204830,70204830,True
3470,71,2006-09-22,jackass: number two,11000000,72778712,85278712,74278712,True
3471,72,1992-03-13,my cousin vinny,11000000,52929168,52929168,41929168,True
3472,73,2014-08-22,if i stay,11000000,50474843,78356170,67356170,True
3473,74,1989-04-07,major league,11000000,49793054,49793054,38793054,True
3474,75,2003-04-04,phone booth,11000000,46566212,97837138,86837138,True
3475,76,2002-01-25,a walk to remember,11000000,41227069,46060861,35060861,True
3476,77,1995-12-29,dead man walking,11000000,39387284,83088295,72088295,True
3477,78,1999-03-05,cruel intentions,11000000,38665260,76238901,65238901,True
3478,79,2015-11-04,brooklyn,11000000,38322743,62076141,51076141,True
3479,80,2008-10-17,the secret life of bees,11000000,37780486,39994347,28994347,True
3480,81,2015-04-01,woman in gold,11000000,33307793,58586407,47586407,True
3481,82,1981-06-12,history of the world: part i,11000000,31672000,31672000,20672000,True
3482,83,2017-12-08,"i, tonya",11000000,30014534,53797409,42797409,True
3483,84,2009-10-23,saw vi,11000000,27693292,69752402,58752402,True
3484,85,2001-10-12,corky romano,11000000,23978402,25116103,14116103,True
3485,86,2019-02-14,fighting with my family,11000000,22958583,39049922,28049922,True
3486,87,1992-08-07,raising cain,11000000,21171695,21171695,10171695,True
3487,88,1978-04-13,f.i.s.t,11000000,20388920,20388920,9388920,True
3488,89,1975-01-01,barry lyndon,11000000,20000000,20169934,9169934,True
3489,90,2013-01-11,quartet,11000000,18388357,56178935,45178935,True
3490,91,2001-11-21,out cold,11000000,13906394,14786394,3786394,True
3491,92,2000-10-13,the ladies man,11000000,13592872,13719474,2719474,True
3492,93,2001-03-30,tomcats,11000000,13558739,13558739,2558739,True
3493,94,2013-12-06,inside llewyn davis,11000000,13248209,32943247,21943247,True
3494,95,2002-04-12,frailty,11000000,13110448,19947280,8947280,True
3495,96,1993-02-19,army of darkness,11000000,11502976,21502976,10502976,True
3496,97,2004-11-12,kinsey,11000000,10214647,17443529,6443529,False
3497,98,2013-05-10,peeples,11000000,9177065,9307166,-1692834,False
3498,99,1993-12-25,what's eating gilbert grape,11000000,9170214,9170214,-1829786,False
3499,100,2016-07-06,sultan,11000000,5599781,72989781,61989781,False
3500,1,2002-02-01,slackers,11000000,4814244,5942218,-5057782,False
3501,2,2003-09-26,the gospel of john,11000000,4068087,4234355,-6765645,False
3502,3,2004-10-10,vera drake,11000000,3753806,13353855,2353855,False
3503,4,2003-01-31,the guru,11000000,3051221,24150550,13150550,False
3504,5,1995-12-14,othello,11000000,2844379,2844379,-8155621,False
3505,6,1995-05-12,the perez family,11000000,2794056,2794056,-8205944,False
3506,7,1970-01-01,the molly maguires,11000000,2200000,2200000,-8800000,False
3507,8,1991-01-01,return to the blue lagoon,11000000,2000000,2000000,-9000000,False
3508,9,2007-09-07,romance and cigarettes,11000000,551002,3231251,-7768749,False
3509,10,2006-11-10,copying beethoven,11000000,355968,6586324,-4413676,False
3510,11,2011-08-26,brighton rock,11000000,229653,229653,-10770347,False
3511,12,2012-11-16,le prã©nom,11000000,61611,25307405,14307405,False
3512,13,2015-05-08,la famille bã©lier,11000000,0,82438670,71438670,False
3513,14,2012-05-04,lol,11000000,0,10431506,-568494,False
3514,15,2016-02-05,misconduct,11000000,0,2352511,-8647489,False
3515,16,2019-12-31,eli,11000000,0,0,-11000000,False
3516,17,2008-10-24,saw v,10800000,56746769,118209778,107409778,True
3517,18,2012-05-25,les intouchables,10800000,13182281,484873045,474073045,True
3518,19,2007-04-27,jindabyne,10800000,399879,2862544,-7937456,False
3519,20,2006-08-11,kabhi alvida naa kehna,10750000,3275443,32575443,21825443,False
3520,21,1979-05-25,alien,10700000,80930630,203628947,192928947,True
3521,22,1982-06-04,poltergeist,10700000,74706019,121706019,111006019,True
3522,23,1999-06-18,an ideal husband,10700000,18542974,31341183,20641183,True
3523,24,2004-12-25,darkness,10600000,22163442,34409206,23809206,True
3524,25,2013-12-06,the last days on mars,10600000,24084,261364,-10338636,False
3525,26,1982-06-11,et: the extra-terrestrial,10500000,435110554,792965326,782465326,True
3526,27,1968-04-02,2001: a space odyssey,10500000,59936321,71928046,61428046,True
3527,28,2007-04-20,in the land of women,10500000,11052958,14140402,3640402,True
3528,29,1994-12-31,there goes my baby,10500000,125169,125169,-10374831,False
3529,30,2004-02-20,the blue butterfly,10400000,1610194,1610194,-8789806,False
3530,31,2001-11-02,le fabuleux destin d'amã©lie poulain,10350000,33201661,174201661,163851661,True
3531,32,2019-01-04,pmc: deo beong-keo,10300000,0,12478635,2178635,False
3532,33,1983-02-18,lovesick,10100000,10143618,10143618,43618,True
3533,34,2010-04-30,housefull,10100000,1183658,18726300,8626300,False
3534,35,2007-08-24,september dawn,10100000,1066555,1066555,-9033445,False
3535,36,2018-10-19,halloween,10000000,159342015,254900667,244900667,True
3536,37,1997-12-05,good will hunting,10000000,138433435,225925989,215925989,True
3537,38,2004-10-22,the grudge,10000000,110359362,187281115,177281115,True
3538,39,2016-08-26,donât breathe,10000000,89217875,158973685,148973685,True
3539,40,1981-06-26,stripes,10000000,85300000,85300000,75300000,True
3540,41,2006-10-27,saw iii,10000000,80238724,163876815,153876815,True
3541,42,2016-07-01,the purge: election year,10000000,79042440,118514727,108514727,True
3542,43,2018-05-18,book club,10000000,68566296,91113683,81113683,True
3543,44,2000-08-25,bring it on,10000000,68353550,90453550,80453550,True
3544,45,2018-01-05,insidious: the last key,10000000,67745330,167885588,157885588,True
3545,46,1999-01-29,she's all that,10000000,63465522,63465522,53465522,True
3546,47,2007-10-26,saw iv,10000000,63300095,135759694,125759694,True
3547,48,2006-02-24,madea's family reunion,10000000,63257940,63320521,53320521,True
3548,49,2005-01-07,white noise,10000000,56094360,92094360,82094360,True
3549,50,1986-10-17,the color of money,10000000,52293000,52293000,42293000,True
3550,51,2015-06-05,insidious chapter 3,10000000,52218558,120453155,110453155,True
3551,52,1992-10-02,the mighty ducks,10000000,50752337,50752337,40752337,True
3552,53,2017-11-03,lady bird,10000000,48958273,78610769,68610769,True
3553,54,2009-11-06,precious (based on the novel push by sapphire),10000000,47566524,68722848,58722848,True
3554,55,2012-05-04,the best exotic marigold hotel,10000000,46383639,134639780,124639780,True
3555,56,2018-06-08,hereditary,10000000,44069456,70133905,60133905,True
3556,57,2018-03-16,"love, simon",10000000,40826341,65520633,55520633,True
3557,58,1989-02-17,bill & ted's excellent adventure,10000000,40485039,40485039,30485039,True
3558,59,1962-10-04,the longest day,10000000,39100000,50100000,40100000,True
3559,60,1996-02-16,happy gilmore,10000000,38623460,41004412,31004412,True
3560,61,2017-10-27,jigsaw,10000000,38052832,102445196,92445196,True
3561,62,2001-08-31,jeepers creepers,10000000,37904175,58939035,48939035,True
3562,63,1985-06-28,st. elmoâs fire,10000000,37800000,37800000,27800000,True
3563,64,1968-12-11,oliver!,10000000,37402877,37402877,27402877,True
3564,65,2001-02-16,recess: school's out,10000000,36696761,44451470,34451470,True
3565,66,1985-07-10,mad max beyond thunderdome,10000000,36230219,36230219,26230219,True
3566,67,1977-11-03,peteâs dragon,10000000,36000000,36000000,26000000,True
3567,68,2016-01-22,the boy,10000000,35819556,68220952,58220952,True
3568,69,1985-10-04,commando,10000000,35073978,35073978,25073978,True
3569,70,2017-05-19,"everything, everything",10000000,34121140,61603136,51603136,True
3570,71,2010-09-17,devil,10000000,33679655,63354114,53354114,True
3571,72,2002-11-22,friday after next,10000000,33253609,33526835,23526835,True
3572,73,2015-03-06,the second best exotic marigold hotel,10000000,33078266,90384306,80384306,True
3573,74,1985-03-22,the last dragon,10000000,33000000,33000000,23000000,True
3574,75,2017-04-28,how to be a latin lover,10000000,32149404,62556228,52556228,True
3575,76,1992-03-06,the lawnmower man,10000000,32100816,32100816,22100816,True
3576,77,2008-10-03,nick and norah's infinite playlist,10000000,31487293,33886017,23886017,True
3577,78,2003-12-19,calendar girls,10000000,31011616,93074616,83074616,True
3578,79,1999-11-12,dogma,10000000,30651422,43948865,33948865,True
3579,80,2018-08-10,slender man,10000000,30564825,51723644,41723644,True
3580,81,2002-09-20,the banger sisters,10000000,30306281,38067218,28067218,True
3581,82,2000-12-08,snatch,10000000,30093107,83593107,73593107,True
3582,83,1989-05-19,road house,10000000,30050028,30050028,20050028,True
3583,84,2018-07-27,teen titans go! to the movies,10000000,29790236,51620593,41620593,True
3584,85,2016-09-09,when the bough breaks,10000000,29747603,30768449,20768449,True
3585,86,1983-06-24,twilight zone: the movie,10000000,29500000,29500000,19500000,True
3586,87,1994-11-23,a low down dirty shame,10000000,29317886,29317886,19317886,True
3587,88,2013-08-30,one direction: this is us,10000000,28873374,68541786,58541786,True
3588,89,2002-09-06,swimfan,10000000,28564995,34084228,24084228,True
3589,90,2006-10-06,employee of the month,10000000,28444855,38364855,28364855,True
3590,91,2015-08-21,sinister 2,10000000,27740955,54104225,44104225,True
3591,92,2016-01-08,the forest,10000000,26594261,40749230,30749230,True
3592,93,2009-11-06,the fourth kind,10000000,26218170,49486874,39486874,True
3593,94,1983-03-25,the outsiders,10000000,25697647,25697647,15697647,True
3594,95,1998-06-12,can't hardly wait,10000000,25358996,25358996,15358996,True
3595,96,2012-08-17,sparkle,10000000,24397469,24660323,14660323,True
3596,97,2016-10-14,kevin hart: what now?,10000000,23591043,23591043,13591043,True
3597,98,2013-04-26,mud,10000000,21590086,31556959,21556959,True
3598,99,2010-11-12,skyline,10000000,21416355,68264973,58264973,True
3599,100,2017-12-01,the disaster artist,10000000,21120616,28717667,18717667,True
3600,1,2016-09-16,blair witch,10000000,20777061,38985577,28985577,True
3601,2,1983-10-21,the dead zone,10000000,20766000,20766000,10766000,True
3602,3,2001-02-02,valentine,10000000,20384136,20384136,10384136,True
3603,4,2006-06-09,a prairie home companion,10000000,20342852,26716191,16716191,True
3604,5,2007-02-23,reno 911!: miami,10000000,20342161,21851362,11851362,True
3605,6,1998-07-24,jane austen's mafia,10000000,19843795,30143795,20143795,True
3606,7,2015-10-23,paranormal activity: the ghost dimension,10000000,18297124,77959374,67959374,True
3607,8,1994-02-25,sugar hill,10000000,18272447,18423914,8423914,True
3608,9,2008-06-20,kit kittredge: an american girl,10000000,17657973,17657973,7657973,True
3609,10,1985-09-27,invasion u.s.a.,10000000,17536256,17536256,7536256,True
3610,11,2005-09-23,roll bounce,10000000,17380866,17433072,7433072,True
3611,12,1998-12-11,rushmore,10000000,17105219,19080435,9080435,True
3612,13,1990-01-19,tremors,10000000,16667084,16667084,6667084,True
3613,14,2005-06-17,the perfect man,10000000,16535005,19535005,9535005,True
3614,15,1990-08-03,mo' better blues,10000000,16153000,16153000,6153000,True
3615,16,2002-01-25,kung pow: enter the fist,10000000,16033556,17033556,7033556,True
3616,17,2016-10-07,the birth of a nation,10000000,15861566,16891011,6891011,True
3617,18,2003-05-30,wrong turn,10000000,15417771,28649556,18649556,True
3618,19,1980-05-16,the long riders,10000000,15198912,15198912,5198912,True
3619,20,1999-03-12,the corruptor,10000000,15164492,15164492,5164492,True
3620,21,2009-08-14,"the goods: live hard, sell hard",10000000,15122676,15297318,5297318,True
3621,22,2011-11-23,my week with marilyn,10000000,14597405,34240572,24240572,True
3622,23,2014-12-25,big eyes,10000000,14482031,27317872,17317872,True
3623,24,2005-08-05,broken flowers,10000000,13744960,40744960,30744960,True
3624,25,2002-06-28,hey arnold! the movie,10000000,13684949,13684949,3684949,True
3625,26,2005-12-30,the matador,10000000,12589255,17300838,7300838,True
3626,27,1997-03-14,love jones,10000000,12554569,12554569,2554569,True
3627,28,2000-12-19,the gift,10000000,12008642,44567606,34567606,True
3628,29,2006-01-20,end of the spear,10000000,11748661,11924041,1924041,True
3629,30,2001-03-09,get over it,10000000,11560259,19860259,9860259,True
3630,31,2000-10-20,the legend of drunken master,10000000,11546543,11546543,1546543,True
3631,32,1999-02-19,office space,10000000,10827813,12179708,2179708,True
3632,33,1999-07-23,drop dead gorgeous,10000000,10571408,10571408,571408,True
3633,34,2019-04-05,the best of enemies,10000000,10205616,10205616,205616,True
3634,35,1998-04-03,the spanish prisoner,10000000,10162034,13835130,3835130,True
3635,36,1999-06-11,le violon rouge,10000000,10019109,10019109,19109,True
3636,37,1998-11-25,very bad things,10000000,9949470,21094974,11094974,False
3637,38,2004-07-09,sleepover,10000000,9408183,9408183,-591817,False
3638,39,2013-01-25,movie 43,10000000,8840453,31164747,21164747,False
3639,40,2018-10-19,can you ever forgive me?,10000000,8803865,11752387,1752387,False
3640,41,1984-10-26,body double,10000000,8801940,8801940,-1198060,False
3641,42,2010-05-21,macgruber,10000000,8525600,8629895,-1370105,False
3642,43,2003-07-18,dirty pretty things,10000000,8112414,14156753,4156753,False
3643,44,2014-03-14,bad words,10000000,7779614,7843145,-2156855,False
3644,45,2015-03-27,while we're young,10000000,7582065,17503828,7503828,False
3645,46,2008-02-01,over her dead body,10000000,7570127,21596074,11596074,False
3646,47,2001-10-24,bones,10000000,7316658,8378853,-1621147,False
3647,48,2012-06-22,seeking a friend for the end of the world,10000000,7078738,11766959,1766959,False
3648,49,2006-12-01,turistas,10000000,7027762,14321070,4321070,False
3649,50,2016-11-11,shut in,10000000,6900335,11360665,1360665,False
3650,51,2011-02-11,cedar rapids,10000000,6861102,7862131,-2137869,False
3651,52,2012-11-30,the collection,10000000,6810754,8890094,-1109906,False
3652,53,1998-10-30,american history x,10000000,6719864,6719864,-3280136,False
3653,54,2004-01-16,teacher's pet: the movie,10000000,6491969,6491969,-3508031,False
3654,55,1999-10-15,the straight story,10000000,6197866,6197866,-3802134,False
3655,56,2002-05-03,deuces wild,10000000,6044618,6244618,-3755382,False
3656,57,2008-03-28,"run, fatboy, run",10000000,6003262,33512260,23512260,False
3657,58,1981-12-18,heartbeeps,10000000,6000000,6000000,-4000000,False
3658,59,2015-03-20,danny collins,10000000,5637066,8465845,-1534155,False
3659,60,2007-07-04,rescue dawn,10000000,5490423,7037886,-2962114,False
3660,61,2000-04-05,black and white,10000000,5241315,5241315,-4758685,False
3661,62,2010-06-18,io sono lâamore,10000000,5005465,15121528,5121528,False
3662,63,2001-10-26,on the line,10000000,4365455,4690802,-5309198,False
3663,64,2018-06-15,gotti,10000000,4286367,6089100,-3910900,False
3664,65,2012-03-16,"jeff, who lives at home",10000000,4269426,4708127,-5291873,False
3665,66,2016-09-30,denial,10000000,4073448,9263940,-736060,False
3666,67,2016-04-29,the man who knew infinity,10000000,3877922,12382122,2382122,False
3667,68,2016-10-14,max steel,10000000,3818664,4563080,-5436920,False
3668,69,2016-03-30,everybody wants some,10000000,3400278,5437126,-4562874,False
3669,70,1996-10-04,crash,10000000,3357324,3357324,-6642676,False
3670,71,2012-10-12,atlas shrugged: part ii,10000000,3336053,3336053,-6663947,False
3671,72,1994-02-04,romeo is bleeding,10000000,3275585,3275585,-6724415,False
3672,73,1999-10-08,the limey,10000000,3193102,6030047,-3969953,False
3673,74,2014-11-14,rosewater,10000000,3128941,3185717,-6814283,False
3674,75,2000-12-22,the house of mirth,10000000,3041803,5149131,-4850869,False
3675,76,1987-05-01,malone,10000000,3000000,3000000,-7000000,False
3676,77,2006-06-02,peaceful warrior,10000000,2893666,3260179,-6739821,False
3677,78,2011-09-09,bucky larson: born to be a star,10000000,2529395,2529395,-7470605,False
3678,79,2000-10-06,bamboozled,10000000,2185266,2373937,-7626063,False
3679,80,1981-02-11,sphinx,10000000,2000000,11400000,1400000,False
3680,81,2013-05-03,the iceman,10000000,1930282,3623609,-6376391,False
3681,82,2015-06-05,testament of youth,10000000,1822250,6646669,-3353331,False
3682,83,2017-04-21,free fire,10000000,1799322,3793739,-6206261,False
3683,84,2011-06-24,a better life,10000000,1759252,1884251,-8115749,False
3684,85,2003-02-28,spider,10000000,1641788,1641788,-8358212,False
3685,86,2000-02-04,gun shy,10000000,1638202,1638202,-8361798,False
3686,87,2002-12-27,nicholas nickleby,10000000,1562800,1562800,-8437200,False
3687,88,2010-04-16,the joneses,10000000,1475746,3541565,-6458435,False
3688,89,2006-06-23,krrish,10000000,1430721,32430721,22430721,False
3689,90,2012-07-27,killer joe,10000000,1291645,4659110,-5340890,False
3690,91,2017-06-02,churchill,10000000,1279681,7582196,-2417804,False
3691,92,2000-08-11,cecil b. demented,10000000,1276984,1953882,-8046118,False
3692,93,2014-03-21,50 to 1,10000000,1069454,1069454,-8930546,False
3693,94,2003-05-02,owning mahowny,10000000,1011054,1011054,-8988946,False
3694,95,2007-10-19,the ten commandments,10000000,952820,1051907,-8948093,False
3695,96,2007-09-07,the brothers solomon,10000000,900926,900926,-9099074,False
3696,97,2008-04-04,my blueberry nights,10000000,866778,22198996,12198996,False
3697,98,1999-08-06,illuminata,10000000,836641,836641,-9163359,False
3698,99,2012-01-20,coriolanus,10000000,749641,2179623,-7820377,False
3699,100,2013-10-04,parkland,10000000,641439,1616353,-8383647,False
3700,1,2002-10-11,swept away,10000000,598645,598645,-9401355,False
3701,2,2008-05-23,"war, inc.",10000000,580862,1299855,-8700145,False
3702,3,2004-04-02,shaolin soccer,10000000,488872,42776032,32776032,False
3703,4,2004-08-27,the brown bunny,10000000,366301,630427,-9369573,False
3704,5,2007-09-14,king of california,10000000,268461,1165102,-8834898,False
3705,6,1997-10-24,rien ne va plus,10000000,245359,5045359,-4954641,False
3706,7,1998-08-14,la femme de chambre du titanic,10000000,244465,244465,-9755535,False
3707,8,2004-12-17,imaginary heroes,10000000,228524,290875,-9709125,False
3708,9,2001-10-26,high heels and low lifes,10000000,226792,226792,-9773208,False
3709,10,2009-08-21,world's greatest dad,10000000,221805,295750,-9704250,False
3710,11,2013-05-03,"cinco de mayo, la batalla",10000000,173472,173472,-9826528,False
3711,12,2010-10-29,welcome to the rileys,10000000,152857,355919,-9644081,False
3712,13,2016-09-09,kicks,10000000,150191,150191,-9849809,False
3713,14,2009-10-09,free style,10000000,141108,721108,-9278892,False
3714,15,2012-06-01,high school,10000000,139034,248133,-9751867,False
3715,16,2007-05-18,severance,10000000,137221,5950002,-4049998,False
3716,17,2006-07-14,edmond,10000000,131719,241719,-9758281,False
3717,18,2010-04-23,joheunnom nabbeunnom isanghannom,10000000,128486,42226657,32226657,False
3718,19,1994-08-26,police academy 7: mission to moscow,10000000,126247,126247,-9873753,False
3719,20,2010-02-19,blood done sign my name,10000000,109383,109383,-9890617,False
3720,21,2010-02-19,the good guy,10000000,100688,106460,-9893540,False
3721,22,2009-10-23,motherhood,10000000,93388,723388,-9276612,False
3722,23,2004-10-15,eulogy,10000000,70527,70527,-9929473,False
3723,24,2014-11-07,elsa & fred,10000000,67657,197901,-9802099,False
3724,25,1998-02-27,an alan smithee film: burn hollywood burn,10000000,45779,45779,-9954221,False
3725,26,2009-08-28,the open road,10000000,19716,19716,-9980284,False
3726,27,2015-07-10,strangerland,10000000,17472,161097,-9838903,False
3727,28,2015-03-13,hross i oss,10000000,11894,11894,-9988106,False
3728,29,2009-10-16,janky promoters,10000000,9069,9069,-9990931,False
3729,30,2007-12-21,blonde ambition,10000000,6422,1537479,-8462521,False
3730,31,2010-08-06,the oxford murders,10000000,4803,17704131,7704131,False
3731,32,2014-12-26,barbecue,10000000,388,247565,-9752435,False
3732,33,2010-12-31,the reef,10000000,0,15037867,5037867,False
3733,34,2008-01-08,white noise 2: the light,10000000,0,8243567,-1756433,False
3734,35,2015-07-21,american heist,10000000,0,2341218,-7658782,False
3735,36,2010-10-08,it's a wonderful afterlife,10000000,0,1642939,-8357061,False
3736,37,2011-06-21,you got served: beat the world,10000000,0,1230542,-8769458,False
3737,38,2009-08-21,fifty dead men walking,10000000,0,997921,-9002079,False
3738,39,2014-09-26,plastic,10000000,0,575371,-9424629,False
3739,40,2015-03-10,jungle shuffle,10000000,0,360898,-9639102,False
3740,41,2009-09-22,adam resurrected,10000000,0,90909,-9909091,False
3741,42,2009-05-26,the devil's tomb,10000000,0,0,-10000000,False
3742,43,2009-12-31,good intentions,10000000,0,0,-10000000,False
3743,44,2007-02-02,partition,10000000,0,0,-10000000,False
3744,45,2012-04-13,detention,10000000,0,0,-10000000,False
3745,46,2014-02-07,nurse 3d,10000000,0,0,-10000000,False
3746,47,2015-05-19,into the grizzly maze,10000000,0,0,-10000000,False
3747,48,2017-09-22,friend request,9900000,3759078,11310835,1410835,False
3748,49,2010-04-30,gunless,9900000,458054,458054,-9441946,False
3749,50,2009-04-03,adventureland,9800000,16044025,17553055,7753055,True
3750,51,2012-12-19,amour,9700000,6738954,36787044,27087044,False
3751,52,2006-04-28,the lost city,9600000,2484186,5256839,-4343161,False
3752,53,2000-01-12,next friday,9500000,57176582,59675307,50175307,True
3753,54,1967-06-13,you only live twice,9500000,43100000,111600000,102100000,True
3754,55,1988-06-10,poltergeist iii,9500000,14114000,14114000,4614000,True
3755,56,2016-12-21,dangal,9500000,12391761,294654618,285154618,True
3756,57,2010-03-19,the runaways,9500000,3573673,5278632,-4221368,False
3757,58,2009-10-30,gentlemen broncos,9500000,115155,119955,-9380045,False
3758,59,2013-12-31,re-kill,9500000,0,0,-9500000,False
3759,60,1963-11-07,it's a mad mad mad mad world,9400000,46300000,60000000,50600000,True
3760,61,2006-11-03,volver,9400000,12899867,87226613,77826613,True
3761,62,2011-11-11,melancholia,9400000,3030848,21817298,12417298,False
3762,63,1981-08-07,heavy metal,9300000,19571091,19571091,10271091,True
3763,64,2012-11-13,jab tak hai jaan,9200000,3047539,5806666,-3393334,False
3764,65,1995-12-29,richard iii,9200000,2684904,4199334,-5000666,False
3765,66,2010-05-21,kites,9200000,1685269,17155193,7955193,False
3766,67,2011-12-31,red dog,9100000,0,20927794,11827794,False
3767,68,2010-12-31,mine vaganti,9100000,0,18872126,9772126,False
3768,69,2003-10-17,the texas chainsaw massacre,9000000,80571655,107967319,98967319,True
3769,70,1971-01-01,fiddler on the roof,9000000,80500000,80500000,71500000,True
3770,71,2014-07-18,the purge: anarchy,9000000,71562550,111534881,102534881,True
3771,72,1965-12-29,thunderball,9000000,63600000,141200000,132200000,True
3772,73,2008-05-30,the strangers,9000000,52597610,83051676,74051676,True
3773,74,1996-11-06,set it off,9000000,36049108,36049108,27049108,True
3774,75,2016-10-21,ouija: origin of evil,9000000,35144505,81831866,72831866,True
3775,76,1999-10-22,the best man,9000000,34102780,34572780,25572780,True
3776,77,1988-11-09,child's play,9000000,33244684,44196684,35196684,True
3777,78,2019-02-13,happy death day 2u,9000000,28051045,64179495,55179495,True
3778,79,2007-06-22,sicko,9000000,24538513,36535837,27535837,True
3779,80,2015-01-30,black or white,9000000,21571189,21971021,12971021,True
3780,81,2000-01-21,down to you,9000000,20035310,20035310,11035310,True
3781,82,2004-07-30,harold & kumar go to white castle,9000000,18225165,18225165,9225165,True
3782,83,2000-10-13,the contender,9000000,17804273,17804273,8804273,True
3783,84,2000-02-18,boiler room,9000000,16963963,28773637,19773637,True
3784,85,2006-12-05,black christmas,9000000,16235738,16235738,7235738,True
3785,86,2016-11-18,the edge of seventeen,9000000,14431633,19096003,10096003,True
3786,87,2016-12-02,jackie,9000000,13960394,36588512,27588512,True
3787,88,1984-03-16,the ice pirates,9000000,13075390,13075390,4075390,True
3788,89,2004-05-14,breakin' all the rules,9000000,12232382,12512317,3512317,True
3789,90,2011-08-12,glee: the 3d concert movie,9000000,11862398,17462398,8462398,True
3790,91,1989-11-08,henry v,9000000,10161099,10176701,1176701,True
3791,92,2016-11-04,loving,9000000,7710234,12898064,3898064,False
3792,93,2007-11-28,the savages,9000000,6623082,10642023,1642023,False
3793,94,2003-04-16,chasing papi,9000000,6126237,12657377,3657377,False
3794,95,2000-09-08,the way of the gun,9000000,6047856,13061935,4061935,False
3795,96,2019-05-17,the sun is also a star,9000000,4950029,5434029,-3565971,False
3796,97,2008-08-22,hamlet 2,9000000,4886216,4934104,-4065896,False
3797,98,2002-09-13,igby goes down,9000000,4777465,4777465,-4222535,False
3798,99,1994-04-29,pcu,9000000,4333569,4333569,-4666431,False
3799,100,2007-03-09,the ultimate gift,9000000,3438735,3438735,-5561265,False
3800,1,2000-09-29,beautiful,9000000,3134509,3134509,-5865491,False
3801,2,2007-06-01,gracie,9000000,2956339,3922043,-5077957,False
3802,3,2013-03-22,the sapphires,9000000,2450867,20395040,11395040,False
3803,4,2016-08-26,greater,9000000,2000093,2000093,-6999907,False
3804,5,2018-12-25,destroyer,9000000,1533324,3681096,-5318904,False
3805,6,2006-08-18,trust the man,9000000,1530535,2548378,-6451622,False
3806,7,2005-08-26,undiscovered,9000000,1069318,1069318,-7930682,False
3807,8,1998-11-06,velvet goldmine,9000000,1053788,4313644,-4686356,False
3808,9,2010-05-14,princess kaiulani,9000000,883887,883887,-8116113,False
3809,10,2003-06-20,the legend of suriyothai,9000000,454255,454255,-8545745,False
3810,11,1991-10-25,due occhi diabolici,9000000,349618,349618,-8650382,False
3811,12,2016-05-06,dheepan,9000000,248795,7704357,-1295643,False
3812,13,2010-01-22,la fille du rer,9000000,208163,208163,-8791837,False
3813,14,2002-10-25,all or nothing,9000000,184255,184255,-8815745,False
3814,15,2010-02-05,red riding: the year of our lord 1974,9000000,148826,148826,-8851174,False
3815,16,2009-07-31,flammen og citronen,9000000,148089,1635241,-7364759,False
3816,17,2010-04-02,leaves of grass,9000000,70066,85527,-8914473,False
3817,18,2006-11-22,opal dream,9000000,14443,14443,-8985557,False
3818,19,2015-05-08,skin trade,9000000,1242,1242,-8998758,False
3819,20,2014-06-17,beneath hill 60,9000000,0,3440939,-5559061,False
3820,21,2015-01-20,veronika decides to die,9000000,0,2243,-8997757,False
3821,22,1968-10-10,barbarella,9000000,0,0,-9000000,False
3822,23,2013-02-01,a haunting in connecticut 2: the ghosts of georgia,9000000,0,0,-9000000,False
3823,24,2012-05-18,polisse,8900000,176988,22744132,13844132,False
3824,25,2015-11-13,heist,8900000,50136,3324131,-5575869,False
3825,26,2011-02-26,ultramarines,8900000,0,0,-8900000,False
3826,27,1986-09-26,crocodile dundee,8800000,174803506,328203506,319403506,True
3827,28,2004-12-31,the i inside,8800000,0,0,-8800000,False
3828,29,2007-11-30,awake,8600000,14373825,32968648,24368648,True
3829,30,2016-11-18,manchester by the sea,8500000,47695371,77733867,69233867,True
3830,31,2009-12-16,crazy heart,8500000,39471742,47417251,38917251,True
3831,32,2008-08-15,star wars: the clone wars,8500000,35161554,68695443,60195443,True
3832,33,2015-02-20,the duff,8500000,34030343,43528634,35028634,True
3833,34,2014-10-31,nightcrawler,8500000,32381218,50334418,41834418,True
3834,35,1987-07-31,the lost boys,8500000,32222567,32222567,23722567,True
3835,36,2019-01-16,dragon ball super: broly,8500000,30376755,122747755,114247755,True
3836,37,1979-11-07,the rose,8500000,29200000,29200000,20700000,True
3837,38,2013-09-27,baggage claim,8500000,21569509,22885836,14385836,True
3838,39,2016-10-07,middle school: the worst years of my life,8500000,20007149,23311293,14811293,True
3839,40,1991-03-01,haakon haakonsen,8500000,15024232,15024232,6524232,True
3840,41,1999-04-23,election,8500000,14943582,17202854,8702854,True
3841,42,2007-03-09,the namesake,8500000,13610521,20288774,11788774,True
3842,43,2013-10-18,all is lost,8500000,6263670,10386814,1886814,False
3843,44,2004-02-27,club dread,8500000,5001655,7573551,-926449,False
3844,45,2009-09-17,bright star,8500000,4444637,17220091,8720091,False
3845,46,2001-09-21,glitter,8500000,4273372,4273372,-4226628,False
3846,47,2014-06-13,the rover,8500000,1109199,3180252,-5319748,False
3847,48,2004-04-23,silmido,8500000,298347,30298347,21798347,False
3848,49,2008-11-07,repo! the genetic opera,8500000,140244,198883,-8301117,False
3849,50,2017-12-31,posledniy bogatyr,8500000,0,30700192,22200192,False
3850,51,2016-11-01,a.c.o.r.n.s.: operation crackdown,8500000,0,1353287,-7146713,False
3851,52,2010-02-12,my name is khan,8470000,4046336,42355526,33885526,False
3852,53,2007-03-23,namastey london,8400000,1207007,6831069,-1568931,False
3853,54,2013-05-31,yeh jawaani hai deewani,8300000,3827466,50827466,42527466,False
3854,55,1999-06-04,limbo,8300000,2160710,2598224,-5701776,False
3855,56,2007-03-16,the wind that shakes the barley,8300000,1829142,25670174,17370174,False
3856,57,2010-04-16,the city of your final destination,8300000,493296,1353296,-6946704,False
3857,58,2006-11-24,kurtlar vadisi - irak,8300000,0,24906717,16606717,False
3858,59,1951-02-23,quo vadis?,8250000,30000000,30028513,21778513,True
3859,60,1965-03-02,the sound of music,8200000,163214286,286214286,278014286,True
3860,61,1984-02-17,footloose,8200000,80000000,80000000,71800000,True
3861,62,1994-10-14,pulp fiction,8000000,107928762,212928762,204928762,True
3862,63,1984-06-22,the karate kid,8000000,90815558,90815558,82815558,True
3863,64,1979-06-22,the muppet movie,8000000,76657000,76657000,68657000,True
3864,65,1984-03-09,splash,8000000,62599495,62599495,54599495,True
3865,66,2006-07-26,little miss sunshine,8000000,59891098,100642353,92642353,True
3866,67,2010-09-17,easy a,8000000,58401464,76200721,68200721,True
3867,68,1986-08-08,stand by me,8000000,52287414,52287414,44287414,True
3868,69,2003-06-27,28 days laterâ¦,8000000,45064915,82955633,74955633,True
3869,70,1979-06-22,escape from alcatraz,8000000,43000000,43000000,35000000,True
3870,71,2004-01-30,you got served,8000000,40066497,50811858,42811858,True
3871,72,2019-05-03,the intruder,8000000,35095904,36005871,28005871,True
3872,73,2011-09-30,50/50,8000000,35016118,41334735,33334735,True
3873,74,1996-04-03,a thin line between love & hate,8000000,34873513,34873513,26873513,True
3874,75,2015-09-02,a walk in the woods,8000000,29499394,37119358,29119358,True
3875,76,2002-10-11,brown sugar,8000000,27362712,28315272,20315272,True
3876,77,1992-03-13,howards end,8000000,26124872,26317943,18317943,True
3877,78,2014-01-31,that awkward moment,8000000,26068955,53068955,45068955,True
3878,79,2008-03-21,shutter,8000000,25928550,47782426,39782426,True
3879,80,1981-12-25,modern problems,8000000,24474312,24474312,16474312,True
3880,81,1969-12-18,on her majesty's secret service,8000000,22800000,82000000,74000000,True
3881,82,1993-05-07,much ado about nothing,8000000,22549338,22549338,14549338,True
3882,83,1992-04-10,the player,8000000,21706101,28876702,20876702,True
3883,84,1982-11-10,creepshow,8000000,20036244,20036244,12036244,True
3884,85,2006-04-28,akeelah and the bee,8000000,18848430,18959424,10959424,True
3885,86,1994-10-14,wes craven's new nightmare,8000000,18090181,18090181,10090181,True
3886,87,1999-10-01,drive me crazy,8000000,17843379,22591451,14591451,True
3887,88,2013-09-18,enough said,8000000,17550872,25621449,17621449,True
3888,89,1998-01-16,half baked,8000000,17394881,17394881,9394881,True
3889,90,2009-01-30,new in town,8000000,16734283,29937909,21937909,True
3890,91,2014-06-27,begin again,8000000,16170632,68838736,60838736,True
3891,92,2000-04-14,american psycho,8000000,15070285,34270285,26270285,True
3892,93,2006-05-19,see no evil,8000000,15032800,18828036,10828036,True
3893,94,2002-08-07,the good girl,8000000,14018296,16585503,8585503,True
3894,95,2006-08-04,"bon cop, bad cop",8000000,12671300,12740705,4740705,True
3895,96,2009-10-30,the boondock saints 2: all saints day,8000000,10273187,10629320,2629320,True
3896,97,2011-04-29,prom,8000000,10130219,10763183,2763183,True
3897,98,1994-04-22,the inkwell,8000000,8864699,8864699,864699,True
3898,99,2000-12-29,shadow of the vampire,8000000,8279017,8279017,279017,True
3899,100,2015-06-12,me and earl and the dying girl,8000000,6758416,9266180,1266180,False
3900,1,2010-10-08,it's kind of a funny story,8000000,6363628,6632950,-1367050,False
3901,2,1996-05-03,the pallbearer,8000000,5656388,5656388,-2343612,False
3902,3,2000-09-22,woman on top,8000000,5018450,10192613,2192613,False
3903,4,2000-05-12,held up,8000000,4714090,4714090,-3285910,False
3904,5,2016-09-02,morgan,8000000,3915251,7298786,-701214,False
3905,6,2015-12-30,anomalisa,8000000,3759286,5706168,-2293832,False
3906,7,2005-12-23,cachã©,8000000,3647381,19891331,11891331,False
3907,8,2010-12-29,another year,8000000,3205706,20005613,12005613,False
3908,9,2002-09-20,8 femmes,8000000,3076425,42376425,34376425,False
3909,10,1991-01-01,showdown in little tokyo,8000000,2275557,2275557,-5724443,False
3910,11,1998-09-25,clay pigeons,8000000,1793359,2256606,-5743394,False
3911,12,2013-12-20,le passã©,8000000,1335672,15752575,7752575,False
3912,13,2018-04-06,lean on pete,8000000,1163056,2455027,-5544973,False
3913,14,2010-11-19,made in dagenham,8000000,1095369,15644196,7644196,False
3914,15,2008-06-06,and when did you last see your father?,8000000,1071240,2476491,-5523509,False
3915,16,2019-05-03,el chicano,8000000,700261,700261,-7299739,False
3916,17,2010-03-05,the secret of kells,8000000,690290,3582797,-4417203,False
3917,18,1997-01-24,prefontaine,8000000,590817,590817,-7409183,False
3918,19,1983-10-28,the wicked lady,8000000,589308,589308,-7410692,False
3919,20,2006-05-05,down in the valley,8000000,568932,973443,-7026557,False
3920,21,2007-05-11,brooklyn rules,8000000,458232,458232,-7541768,False
3921,22,2003-10-24,the singing detective,8000000,336456,524747,-7475253,False
3922,23,2007-06-15,fido,8000000,298110,456814,-7543186,False
3923,24,2018-10-26,london fields,8000000,252676,433732,-7566268,False
3924,25,2011-09-16,restless,8000000,163753,2772511,-5227489,False
3925,26,1998-06-12,the land girls,8000000,146083,146083,-7853917,False
3926,27,2007-05-18,the wendell baker story,8000000,127188,127188,-7872812,False
3927,28,2010-10-29,wild target,8000000,109338,5314194,-2685806,False
3928,29,2008-04-18,pathology,8000000,109045,3270974,-4729026,False
3929,30,2012-10-05,wuthering heights,8000000,100915,2721534,-5278466,False
3930,31,2016-11-18,a street cat named bob,8000000,82703,17382693,9382693,False
3931,32,2006-08-18,10th & wolf,8000000,54702,143782,-7856218,False
3932,33,2015-05-22,aloft,8000000,53086,237688,-7762312,False
3933,34,2011-10-14,fireflies in the garden,8000000,36884,3587191,-4412809,False
3934,35,2005-09-23,dear wendy,8000000,23106,446438,-7553562,False
3935,36,2001-04-27,akira,8000000,19585,19585,-7980415,False
3936,37,2005-12-31,welcome to dongmakgol,8000000,0,48000000,40000000,False
3937,38,2013-09-20,feichang xingyun,8000000,0,21970000,13970000,False
3938,39,2017-09-29,"don gato, el inicio de la pandilla",8000000,0,4604656,-3395344,False
3939,40,2007-09-04,the death and life of bobby z,8000000,0,414617,-7585383,False
3940,41,2018-04-24,backstabbing for beginners,8000000,0,343773,-7656227,False
3941,42,2014-08-12,swelter,8000000,0,44197,-7955803,False
3942,43,2007-11-30,maurice richard,8000000,0,0,-8000000,False
3943,44,2015-02-24,green street hooligans: underground,8000000,0,0,-8000000,False
3944,45,2009-12-31,christmas in beverly hills,8000000,0,0,-8000000,False
3945,46,2015-12-31,henry joseph church,8000000,0,0,-8000000,False
3946,47,2016-05-06,code of honor,8000000,0,0,-8000000,False
3947,48,2019-06-21,burn your maps,8000000,0,0,-8000000,False
3948,49,2006-01-27,imagine me & you,7900000,672243,3129471,-4770529,False
3949,50,2003-07-04,swimming pool,7800000,10130108,24021282,16221282,True
3950,51,1990-02-23,the blood of heroes,7700000,882290,882290,-6817710,False
3951,52,2015-04-14,loin des hommes,7700000,5336,1080428,-6619572,False
3952,53,1989-12-13,driving miss daisy,7500000,106593296,106593296,99093296,True
3953,54,1997-09-26,soul food,7500000,43492389,43492389,35992389,True
3954,55,2009-07-17,(500) days of summer,7500000,32425665,34439060,26939060,True
3955,56,1996-02-23,rumble in the bronx,7500000,32281907,36238752,28738752,True
3956,57,2006-03-17,thank you for smoking,7500000,24793509,40016662,32516662,True
3957,58,2007-06-08,hostel: part ii,7500000,17544812,33606409,26106409,True
3958,59,2009-10-09,an education,7500000,12574914,29652736,22152736,True
3959,60,2009-09-04,extract,7500000,10823158,10849158,3349158,True
3960,61,2002-12-20,narc,7500000,10465659,11843260,4343260,True
3961,62,2005-10-21,shopgirl,7500000,10284523,11758418,4258418,True
3962,63,1984-03-09,the hotel new hampshire,7500000,5142858,5142858,-2357142,False
3963,64,2002-03-08,men with brooms,7500000,4239767,4239767,-3260233,False
3964,65,2008-02-22,witless protection,7500000,4151836,4151836,-3348164,False
3965,66,2004-11-24,the work and the glory,7500000,3347647,3347647,-4152353,False
3966,67,2011-12-21,albert nobbs,7500000,3014696,8539003,1039003,False
3967,68,2016-06-24,the neon demon,7500000,1333124,3559803,-3940197,False
3968,69,2003-07-24,masked and anonymous,7500000,533344,555335,-6944665,False
3969,70,2018-04-13,borg vs mcenroe,7500000,231346,3257922,-4242078,False
3970,71,2002-09-13,betty fisher et autres histoires,7500000,206400,206400,-7293600,False
3971,72,2004-08-06,code 46,7500000,197148,1788324,-5711676,False
3972,73,2001-12-31,the hole,7500000,0,10834406,3334406,False
3973,74,2015-01-09,black november,7500000,0,32572,-7467428,False
3974,75,2015-02-24,outside bet,7500000,0,13524,-7486476,False
3975,76,2015-05-15,pound of flesh,7500000,0,0,-7500000,False
3976,77,2017-01-13,the bye bye man,7400000,22395806,31187727,23787727,True
3977,78,2007-04-27,ta ra rum pum,7400000,872643,9443864,2043864,False
3978,79,2005-05-06,crash,7303082,55334418,101173038,93869956,True
3979,80,2007-12-25,persepolis,7300000,4443403,25397187,18097187,False
3980,81,2010-04-30,harry brown,7300000,1818681,12023606,4723606,False
3981,82,2011-05-27,die welle,7250000,0,35122948,27872948,False
3982,83,1971-12-17,diamonds are forever,7200000,43800000,116000000,108800000,True
3983,84,1999-10-15,the omega code,7200000,12610552,12678312,5478312,True
3984,85,2011-09-16,3,7200000,59774,295492,-6904508,False
3985,86,2007-12-05,juno,7000000,143495265,231450102,224450102,True
3986,87,1972-03-15,the godfather,7000000,134966411,268500000,261500000,True
3987,88,2012-06-29,magic mike,7000000,113721571,170549753,163549753,True
3988,89,1983-04-15,flashdance,7000000,90463574,201463574,194463574,True
3989,90,2018-03-16,i can only imagine,7000000,83482352,85604221,78604221,True
3990,91,2019-03-15,five feet apart,7000000,45729221,80504421,73504421,True
3991,92,1993-11-12,the piano,7000000,40157856,40168957,33168957,True
3992,93,2011-05-06,jumping the broom,7000000,37295394,38158601,31158601,True
3993,94,1973-06-27,live and let die,7000000,35400000,161800000,154800000,True
3994,95,2000-01-12,my dog skip,7000000,34099640,35795319,28795319,True
3995,96,2003-01-24,darkness falls,7000000,32539681,47289758,40289758,True
3996,97,2008-02-14,"definitely, maybe",7000000,32241649,55617866,48617866,True
3997,98,2005-10-07,"good night, and good luck",7000000,31501218,56586901,49586901,True
3998,99,2005-09-30,capote,7000000,28750530,49924079,42924079,True
3999,100,1974-03-29,the great gatsby,7000000,26533200,26533200,19533200,True
4000,1,2006-08-04,the descent,7000000,26024456,57051053,50051053,True
4001,2,1995-08-25,desperado,7000000,25532388,25532388,18532388,True
4002,3,1976-01-01,logan's run,7000000,25000000,25000000,18000000,True
4003,4,2017-04-07,gifted,7000000,24801212,36964656,29964656,True
4004,5,1996-03-08,fargo,7000000,24567751,51204567,44204567,True
4005,6,2001-04-11,kingdom come,7000000,23247539,23393939,16393939,True
4006,7,1974-12-20,the man with the golden gun,7000000,21000000,97600000,90600000,True
4007,8,1988-02-12,action jackson,7000000,20257000,20257000,13257000,True
4008,9,1983-05-13,breathless,7000000,19910002,19910002,12910002,True
4009,10,2000-05-05,michael jordan to the max,7000000,18642318,18642318,11642318,True
4010,11,2015-06-19,dope,7000000,17506470,18190831,11190831,True
4011,12,2005-07-22,the devil's rejects,7000000,17044981,20940428,13940428,True
4012,13,2019-05-24,brightburn,7000000,16794432,27989498,20989498,True
4013,14,2014-01-17,devil's due,7000000,15821461,36146087,29146087,True
4014,15,1996-03-22,flirting with disaster,7000000,14853474,16149180,9149180,True
4015,16,2014-11-14,beyond the lights,7000000,14618727,14618727,7618727,True
4016,17,1992-07-31,buffy the vampire slayer,7000000,14231669,14231669,7231669,True
4017,18,1999-08-25,in too deep,7000000,14026509,15471229,8471229,True
4018,19,2003-04-11,"house of 1,000 corpses",7000000,12634962,17005466,10005466,True
4019,20,1985-10-11,silver bullet,7000000,10803211,10803211,3803211,True
4020,21,2003-10-10,house of the dead,7000000,10199354,13860078,6860078,True
4021,22,2009-10-02,a serious man,7000000,9228788,30360570,23360570,True
4022,23,2010-07-30,get low,7000000,9176933,10828305,3828305,True
4023,24,2009-12-11,a single man,7000000,9176000,28142379,21142379,True
4024,25,1991-01-10,warlock,7000000,8824553,8824553,1824553,True
4025,26,1988-08-12,the last temptation of christ,7000000,8373585,8373585,1373585,True
4026,27,2010-06-18,cyrus,7000000,7468936,10062896,3062896,True
4027,28,1999-09-01,outside providence,7000000,7309628,7824358,824358,True
4028,29,2005-02-11,bride & prejudice,7000000,6601079,25269040,18269040,False
4029,30,2002-11-29,rabbit-proof fence,7000000,6199600,16866928,9866928,False
4030,31,2007-07-27,who's your caddy?,7000000,5694308,5694308,-1305692,False
4031,32,1992-05-01,split second,7000000,5430822,5430822,-1569178,False
4032,33,1991-03-08,nikita,7000000,5017971,5017971,-1982029,False
4033,34,2001-12-14,the other side of heaven,7000000,4720371,4720371,-2279629,False
4034,35,1990-09-28,dark angel,7000000,4372561,4372561,-2627439,False
4035,36,1986-06-27,american anthem,7000000,3571624,3571624,-3428376,False
4036,37,2004-11-12,veer-zaara,7000000,2938532,7017859,17859,False
4037,38,2008-05-02,redbelt,7000000,2344847,2667084,-4332916,False
4038,39,1999-08-27,a dog of flanders,7000000,2165637,2165637,-4834363,False
4039,40,2002-10-18,auto focus,7000000,2062066,2703821,-4296179,False
4040,41,2011-10-21,the mighty macs,7000000,1891936,1891936,-5108064,False
4041,42,2010-12-22,somewhere,7000000,1785645,17023121,10023121,False
4042,43,2012-01-13,we need to talk about kevin,7000000,1738692,10765283,3765283,False
4043,44,2007-02-02,factory girl,7000000,1661464,1661464,-5338536,False
4044,45,2013-11-15,the christmas candle,7000000,1632000,1933829,-5066171,False
4045,46,2009-09-25,i hope they serve beer in hell,7000000,1429299,1429453,-5570547,False
4046,47,1983-04-08,losin' it,7000000,1246141,1246141,-5753859,False
4047,48,2010-05-07,mother and child,7000000,1110509,6537179,-462821,False
4048,49,1977-08-05,march or die,7000000,1000000,1000000,-6000000,False
4049,50,1996-07-12,les visiteurs,7000000,659000,98754000,91754000,False
4050,51,2015-10-02,freeheld,7000000,546201,1732228,-5267772,False
4051,52,2014-04-02,dom hemingway,7000000,523511,1857458,-5142542,False
4052,53,2010-07-30,the extra man,7000000,453377,492108,-6507892,False
4053,54,2011-05-13,hesher,7000000,382946,382946,-6617054,False
4054,55,1998-03-13,chairman of the board,7000000,306715,306715,-6693285,False
4055,56,2003-02-14,gerry,7000000,254683,719699,-6280301,False
4056,57,2006-05-12,wah-wah,7000000,234750,463039,-6536961,False
4057,58,2003-06-13,the heart of me,7000000,196067,196067,-6803933,False
4058,59,2010-03-26,ca$h,7000000,46488,46488,-6953512,False
4059,60,2015-01-30,trudno byt bogom,7000000,31443,41038,-6958962,False
4060,61,2000-01-21,the boondock saints,7000000,30471,411874,-6588126,False
4061,62,2014-01-28,snezhnaya koroleva,7000000,0,15193977,8193977,False
4062,63,2016-12-06,oddball,7000000,0,10237229,3237229,False
4063,64,2015-08-18,z storm,7000000,0,2053330,-4946670,False
4064,65,2015-12-31,geroy,7000000,0,1545121,-5454879,False
4065,66,2013-07-23,twixt,7000000,0,1268346,-5731654,False
4066,67,2015-11-20,criminal activities,7000000,0,386744,-6613256,False
4067,68,2007-12-11,high school musical 2,7000000,0,0,-7000000,False
4068,69,2008-12-12,the kings of appletown,7000000,0,0,-7000000,False
4069,70,2008-03-11,stargate - the ark of truth,7000000,0,0,-7000000,False
4070,71,2015-09-01,alpha & omega: the legend of the saw tooth cave,7000000,0,0,-7000000,False
4071,72,1985-06-28,pale rider,6900000,41410568,41410568,34510568,True
4072,73,2012-09-21,house at the end of the street,6900000,31611916,44103982,37203982,True
4073,74,1993-09-24,dazed and confused,6900000,7950889,7950889,1050889,True
4074,75,2017-01-31,two lovers and a bear,6840000,0,22273,-6817727,False
4075,76,2010-09-17,incendies,6800000,6857096,16038343,9238343,True
4076,77,2000-08-11,aimã©e & jaguar,6800000,927107,927107,-5872893,False
4077,78,2005-08-05,the chumscrubber,6800000,49526,49526,-6750474,False
4078,79,2004-04-09,shade,6800000,25032,9533964,2733964,False
4079,80,2010-09-10,bran nue dae,6750000,113568,6812530,62530,False
4080,81,2004-09-03,"remember me, my love",6700000,223878,223878,-6476122,False
4081,82,2010-05-21,perrierâs bounty,6600000,828,828,-6599172,False
4082,83,2008-09-19,tropa de elite,6537890,8744,14319195,7781305,False
4083,84,2014-10-03,annabelle,6500000,84273813,256862920,250362920,True
4084,85,2008-02-01,hannah montana/miley cyrus: best of both worlds concert tour,6500000,65281781,70712099,64212099,True
4085,86,1991-07-12,boyz n the hood,6500000,56190094,56215095,49715095,True
4086,87,1987-07-24,la bamba,6500000,54215416,54215416,47715416,True
4087,88,1981-05-22,the four seasons,6500000,42488161,42488161,35988161,True
4088,89,1980-01-01,dressed to kill,6500000,31899000,31899000,25399000,True
4089,90,1993-04-02,the adventures of huck finn,6500000,24103594,24103594,17603594,True
4090,91,1999-04-09,go!,6500000,16875273,28383441,21883441,True
4091,92,2006-04-07,friends with money,6500000,13368437,18110152,11610152,True
4092,93,1971-01-01,the andromeda strain,6500000,12376563,12376563,5876563,True
4093,94,1999-10-22,bats,6500000,10155691,10155691,3655691,True
4094,95,2017-10-20,same kind of different as me,6500000,6423605,6423605,-76395,False
4095,96,2003-03-07,nowhere in africa,6500000,6173485,6173485,-326515,False
4096,97,2011-12-02,shame,6500000,4002293,20412841,13912841,False
4097,98,2005-05-13,layer cake,6500000,2339957,11745931,5245931,False
4098,99,2013-05-31,the east,6500000,2274649,3027956,-3472044,False
4099,100,2005-10-21,the work and the glory: american zion,6500000,2025032,2025032,-4474968,False
4100,1,2009-11-13,the messenger,6500000,1109660,1744952,-4755048,False
4101,2,2004-07-23,a home at the end of the world,6500000,1029017,1033810,-5466190,False
4102,3,2001-08-17,aberdeen,6500000,64148,64148,-6435852,False
4103,4,2011-12-31,tracker,6500000,0,3149,-6496851,False
4104,5,1984-10-26,the terminator,6400000,38019031,78019031,71619031,True
4105,6,2004-02-27,"good bye, lenin!",6400000,4063859,79384539,72984539,False
4106,7,2007-10-10,control,6400000,871577,8902141,2502141,False
4107,8,2009-10-09,the damned united,6400000,449865,4199874,-2200126,False
4108,9,2008-02-22,die fã¤lscher,6250000,5488570,20199663,13949663,False
4109,10,1988-01-15,return of the living dead part ii,6200000,9205924,9205924,3005924,True
4110,11,2009-02-13,gomorra,6200000,1579146,37339594,31139594,False
4111,12,1995-10-20,mallrats,6100000,2108367,2108367,-3991633,False
4112,13,1978-06-16,grease,6000000,181813770,387510179,381510179,True
4113,14,1986-12-19,platoon,6000000,137963328,137978395,131978395,True
4114,15,2004-06-23,fahrenheit 9/11,6000000,119114517,221148959,215148959,True
4115,16,1969-10-24,butch cassidy and the sundance kid,6000000,102308900,102310653,96310653,True
4116,17,1964-08-26,mary poppins,6000000,102272145,102272145,96272145,True
4117,18,1980-09-19,ordinary people,6000000,52302978,52302978,46302978,True
4118,19,2018-05-11,breaking in,6000000,46840590,51411620,45411620,True
4119,20,1961-10-18,west side story,6000000,43700000,43700000,37700000,True
4120,21,1956-10-17,around the world in 80 days,6000000,42000000,42000000,36000000,True
4121,22,1980-07-25,caddyshack,6000000,39846344,39846344,33846344,True
4122,23,2001-03-23,the brothers,6000000,27457409,27958191,21958191,True
4123,24,2008-12-17,the wrestler,6000000,26238243,46634275,40634275,True
4124,25,1989-06-30,do the right thing,6000000,26004026,26004026,20004026,True
4125,26,1981-07-10,escape from new york,6000000,25244700,25245925,19245925,True
4126,27,1999-07-16,the wood,6000000,25059640,25059640,19059640,True
4127,28,1995-08-16,the usual suspects,6000000,23341568,34449356,28449356,True
4128,29,1989-08-11,a nightmare on elm street: the dream child,6000000,22168359,22168359,16168359,True
4129,30,2002-04-05,national lampoonâs van wilder,6000000,21305259,39241323,33241323,True
4130,31,1946-12-31,duel in the sun,6000000,20400000,20400000,14400000,True
4131,32,2000-09-27,best in show,6000000,18621249,20695413,14695413,True
4132,33,2019-03-29,unplanned,6000000,18107621,18107621,12107621,True
4133,34,2006-09-27,the last king of scotland,6000000,17606684,49155371,43155371,True
4134,35,2003-04-16,a mighty wind,6000000,17583468,18504539,12504539,True
4135,36,2019-02-08,the prodigy,6000000,14856291,19789712,13789712,True
4136,37,2018-11-30,the possession of hannah grace,6000000,14836174,42785387,36785387,True
4137,38,1988-02-12,school daze,6000000,14545844,14545844,8545844,True
4138,39,2007-08-08,daddy day camp,6000000,13235267,18209872,12209872,True
4139,40,1988-10-21,mystic pizza,6000000,12793213,12793213,6793213,True
4140,41,1998-03-20,mr. nice guy,6000000,12716953,31716953,25716953,True
4141,42,1956-08-21,war and peace,6000000,12500000,12524028,6524028,True
4142,43,1998-04-24,sliding doors,6000000,11911200,58809149,52809149,True
4143,44,1995-05-24,tales from the hood,6000000,11784569,11784569,5784569,True
4144,45,1989-10-13,halloween 5: the revenge of michael myers,6000000,11642254,11642254,5642254,True
4145,46,2012-09-07,the words,6000000,11494838,16369708,10369708,True
4146,47,2016-01-15,the lady in the van,6000000,10021175,42320503,36320503,True
4147,48,2012-04-27,bernie,6000000,9204489,10106975,4106975,True
4148,49,2000-12-15,pollock,6000000,8596914,10557291,4557291,True
4149,50,2008-02-15,dolphins and whales tribes of the ocean 3d,6000000,7714996,17252287,11252287,True
4150,51,1999-02-26,200 cigarettes,6000000,6852450,6852450,852450,True
4151,52,2010-03-19,city island,6000000,6671283,8173486,2173486,True
4152,53,2012-03-16,casa de mi padre,6000000,5909483,8446952,2446952,False
4153,54,2011-07-29,the guard,6000000,5359774,21197454,15197454,False
4154,55,2000-04-21,the virgin suicides,6000000,4859475,10619770,4619770,False
4155,56,2008-08-29,college,6000000,4694491,6176114,176114,False
4156,57,2006-09-22,la science des rãªves,6000000,4670644,15137932,9137932,False
4157,58,1998-12-04,little voice,6000000,4595000,21787233,15787233,False
4158,59,2009-03-13,miss march,6000000,4543320,4713059,-1286941,False
4159,60,1999-02-05,simply irresistible,6000000,4398989,4398989,-1601011,False
4160,61,2014-07-18,wish i was here,6000000,3591299,6591365,591365,False
4161,62,2006-12-21,venus,6000000,3347411,7818479,1818479,False
4162,63,2014-03-14,veronica mars,6000000,3322127,3485383,-2514617,False
4163,64,1993-08-27,only the strong,6000000,3273588,3273588,-2726412,False
4164,65,2001-07-20,hedwig and the angry inch,6000000,3067312,3740030,-2259970,False
4165,66,2003-10-31,shattered glass,6000000,2207975,3456602,-2543398,False
4166,67,2008-07-03,the wackness,6000000,2077046,3330012,-2669988,False
4167,68,2001-11-16,novocaine,6000000,2025238,2522928,-3477072,False
4168,69,2009-02-06,polytechnique,6000000,1418304,1418304,-4581696,False
4169,70,2011-07-15,snow flower and the secret fan,6000000,1348205,11348205,5348205,False
4170,71,2018-09-14,mandy,6000000,1214525,1427656,-4572344,False
4171,72,2001-12-07,the business of strangers,6000000,1030920,1290920,-4709080,False
4172,73,2011-04-29,jã»san-nin no shikaku,6000000,802778,18727440,12727440,False
4173,74,1991-08-30,beastmaster 2: through the portal of time,6000000,773490,773490,-5226510,False
4174,75,1969-06-18,the wild bunch,6000000,509424,509424,-5490576,False
4175,76,2011-03-25,the 5th quarter,6000000,408159,408159,-5591841,False
4176,77,1979-02-02,the first great train robbery,6000000,391942,391942,-5608058,False
4177,78,2002-12-20,morvern callar,6000000,267194,267194,-5732806,False
4178,79,2003-10-10,the flower of evil,6000000,181798,181798,-5818202,False
4179,80,2011-03-04,akmareul boatda,6000000,129210,13168809,7168809,False
4180,81,2006-11-10,come early morning,6000000,119452,119452,-5880548,False
4181,82,2010-04-02,the greatest,6000000,115862,117796,-5882204,False
4182,83,2012-12-07,deadfall,6000000,66351,1673635,-4326365,False
4183,84,2009-05-08,julia,6000000,65108,1365108,-4634892,False
4184,85,2002-04-05,lucky break,6000000,54606,4316497,-1683503,False
4185,86,2008-09-05,"surfer, dude",6000000,36497,36497,-5963503,False
4186,87,2015-01-23,song one,6000000,32251,437089,-5562911,False
4187,88,2007-10-03,lake of fire,6000000,25317,26007,-5973993,False
4188,89,2010-04-02,don mckay,6000000,13722,13722,-5986278,False
4189,90,2005-08-12,11:14,6000000,0,0,-6000000,False
4190,91,2010-02-09,icarus,6000000,0,0,-6000000,False
4191,92,1995-12-19,men of war,6000000,0,0,-6000000,False
4192,93,2011-03-15,a shine of rainbows,6000000,0,0,-6000000,False
4193,94,2011-12-31,freaky deaky,6000000,0,0,-6000000,False
4194,95,2011-05-10,the hit list,6000000,0,0,-6000000,False
4195,96,1983-02-04,videodrome,5952000,2120439,2120439,-3831561,False
4196,97,1996-08-02,emma,5900000,22231658,37831658,31931658,True
4197,98,2003-03-21,l\'auberge espagnole,5900000,3895664,3895664,-2004336,False
4198,99,1968-02-08,planet of the apes,5800000,33395426,33395426,27595426,True
4199,100,1965-03-07,the train,5800000,6800000,6800000,1000000,True
4200,1,2011-03-18,winter in wartime,5800000,542860,9662214,3862214,False
4201,2,2003-10-03,foolproof,5800000,230312,421021,-5378979,False
4202,3,2012-10-05,trade of innocents,5800000,15091,15091,-5784909,False
4203,4,2006-09-08,tom yum goong,5700000,12044087,43044087,37344087,True
4204,5,1999-08-27,stiff upper lips,5700000,69582,69582,-5630418,False
4205,6,2012-09-07,the inbetweeners,5700000,35955,86051320,80351320,False
4206,7,2010-07-16,valhalla rising,5700000,30638,731613,-4968387,False
4207,8,2003-03-12,bend it like beckham,5600000,32543449,74566042,68966042,True
4208,9,2006-09-01,crossover,5600000,7009668,7009668,1409668,True
4209,10,2002-06-21,sunshine state,5600000,3064356,3281898,-2318102,False
4210,11,2010-07-16,standing ovation,5600000,531806,531806,-5068194,False
4211,12,2012-12-07,khiladi 786,5600000,385422,14683763,9083763,False
4212,13,2010-07-09,[rec] 2,5600000,27766,18527766,12927766,False
4213,14,1973-12-25,the sting,5500000,159616327,159616327,154116327,True
4214,15,1981-09-25,chariots of fire,5500000,61558162,61865947,56365947,True
4215,16,2005-02-25,diary of a mad black woman,5500000,50406346,50458356,44958356,True
4216,17,1996-11-22,shine,5500000,35811509,36672493,31172493,True
4217,18,2013-09-27,don jon,5500000,24477704,41268579,35768579,True
4218,19,1973-08-22,high plains drifter,5500000,15700000,15700000,10200000,True
4219,20,2018-09-28,hell fest,5500000,11107431,18119231,12619231,True
4220,21,2003-06-06,mambo italiano,5500000,9282750,12399772,6899772,True
4221,22,2001-07-20,ghost world,5500000,6217849,8761608,3261608,True
4222,23,2001-12-14,iris,5500000,5580479,5580479,80479,True
4223,24,1980-06-06,galaxina,5500000,4865000,4865000,-635000,False
4224,25,2004-11-26,les choristes,5500000,3629758,83529758,78029758,False
4225,26,2003-10-03,wonderland,5500000,1060512,1060512,-4439488,False
4226,27,2005-07-01,de battre mon coeur s'est arrãªtã©,5500000,1023424,8589831,3089831,False
4227,28,2011-04-01,haevnen,5500000,1008098,15867314,10367314,False
4228,29,2011-10-21,le havre,5500000,611709,13480196,7980196,False
4229,30,2002-05-17,harvard man,5500000,56653,56653,-5443347,False
4230,31,2011-07-15,salvation boulevard,5500000,28468,28468,-5471532,False
4231,32,2015-01-23,r100,5500000,24956,24956,-5475044,False
4232,33,2015-05-05,miss julie,5500000,0,863895,-4636105,False
4233,34,2008-12-31,animals,5500000,0,0,-5500000,False
4234,35,2003-03-07,irreversible,5400000,792200,8133256,2733256,False
4235,36,2013-02-26,tao jie,5400000,0,4728896,-671104,False
4236,37,2006-01-27,rang de basanti,5300000,2197694,29197694,23897694,False
4237,38,2013-07-19,grabbers,5300000,0,440821,-4859179,False
4238,39,2013-10-11,la vie d'adã¨le â chapitres 1 & 2,5250000,2450504,22914479,17664479,False
4239,40,2012-04-27,hodejegerne,5250000,1200010,20188740,14938740,False
4240,41,2007-08-03,the ten,5250000,769726,786677,-4463323,False
4241,42,2000-10-27,a room for romeo brass,5250000,20097,20097,-5229903,False
4242,43,2017-02-24,the girl with all the gifts,5250000,0,4801837,-448163,False
4243,44,1944-08-01,wilson,5200000,2000000,2000000,-3200000,False
4244,45,2005-08-05,saint ralph,5200000,795126,1695126,-3504874,False
4245,46,2011-04-22,dum maaro dum,5200000,564489,11633427,6433427,False
4246,47,1980-10-03,somewhere in time,5100000,9709597,9709597,4609597,True
4247,48,2002-04-19,my big fat greek wedding,5000000,241438208,374890034,369890034,True
4248,49,2017-02-24,get out,5000000,176040665,255367951,250367951,True
4249,50,2017-01-20,split,5000000,138141585,278964806,273964806,True
4250,51,2011-10-21,paranormal activity 3,5000000,104028807,207039844,202039844,True
4251,52,2005-10-28,saw ii,5000000,87025093,152925093,147925093,True
4252,53,2013-09-13,insidious chapter 2,5000000,83586447,161921515,156921515,True
4253,54,2016-03-11,10 cloverfield lane,5000000,72082999,108286422,103286422,True
4254,55,2016-07-22,lights out,5000000,67268835,148806510,143806510,True
4255,56,2015-09-11,the visit,5000000,65206105,98677816,93677816,True
4256,57,2002-10-25,jackass: the movie,5000000,64282312,79282312,74282312,True
4257,58,2017-10-13,happy death day,5000000,55683845,125010260,120010260,True
4258,59,2012-10-19,paranormal activity 4,5000000,53900335,142817992,137817992,True
4259,60,2014-10-24,ouija,5000000,50856010,103300632,98300632,True
4260,61,1987-02-27,a nightmare on elm street 3: dream warriors,5000000,44793222,44793222,39793222,True
4261,62,2013-08-30,no se aceptan devoluciones,5000000,44467206,100486616,95486616,True
4262,63,2015-08-07,the gift,5000000,43787265,58978477,53978477,True
4263,64,2017-06-23,the big sick,5000000,42872467,53972860,48972860,True
4264,65,1975-05-16,the return of the pink panther,5000000,41833347,41833347,36833347,True
4265,66,2019-05-31,ma,5000000,36049540,44300625,39300625,True
4266,67,1953-09-16,the robe,5000000,36000000,36008303,31008303,True
4267,68,1991-09-13,freddyâs dead: the final nightmare,5000000,34872033,34872033,29872033,True
4268,69,2003-12-24,monster,5000000,34469210,64240813,59240813,True
4269,70,2014-01-03,paranormal activity: the marked ones,5000000,32462372,90904854,85904854,True
4270,71,1954-12-23,"20,000 leagues under the sea",5000000,28200000,28200000,23200000,True
4271,72,2014-04-11,oculus,5000000,27695246,44115496,39115496,True
4272,73,2013-11-01,dallas buyers club,5000000,27298285,60611845,55611845,True
4273,74,2015-08-26,no escape,5000000,27288872,42844516,37844516,True
4274,75,1980-10-03,the elephant man,5000000,26010864,26010864,21010864,True
4275,76,2015-02-27,the lazarus effect,5000000,25801570,38359310,33359310,True
4276,77,2001-03-16,memento,5000000,25544867,39723096,34723096,True
4277,78,2011-08-26,our idiot brother,5000000,24814830,25861249,20861249,True
4278,79,2018-03-09,the strangers: prey at night,5000000,24431472,29960051,24960051,True
4279,80,2006-07-21,clerks ii,5000000,24148068,27342246,22342246,True
4280,81,1998-04-08,the players club,5000000,23047939,23047939,18047939,True
4281,82,2000-10-13,billy elliot,5000000,21995263,109253745,104253745,True
4282,83,2013-07-05,the way way back,5000000,21502690,26853810,21853810,True
4283,84,2014-08-29,"as above, so below",5000000,21222315,41824066,36824066,True
4284,85,2016-04-01,godâs not dead 2,5000000,20773069,23551286,18551286,True
4285,86,1997-12-17,the apostle,5000000,20733485,21277770,16277770,True
4286,87,1982-11-03,the man from snowy river,5000000,20659423,20659423,15659423,True
4287,88,1991-10-23,house party 2,5000000,19438638,19438638,14438638,True
4288,89,1999-03-26,doug's 1st movie,5000000,19421271,19421271,14421271,True
4289,90,2016-02-19,race,5000000,19115191,23745772,18745772,True
4290,91,1981-09-18,mommie dearest,5000000,19032000,25032000,20032000,True
4291,92,2015-01-16,still alice,5000000,18656400,41699612,36699612,True
4292,93,1988-10-01,halloween 4: the return of michael myers,5000000,17768757,17768757,12768757,True
4293,94,2011-09-02,apollo 18,5000000,17686929,26517819,21517819,True
4294,95,2018-03-23,"paul, apostle of christ",5000000,17547999,25529498,20529498,True
4295,96,2014-10-10,addicted,5000000,17390770,17499242,12499242,True
4296,97,2001-08-31,o (othello),5000000,16017403,16017403,11017403,True
4297,98,1995-09-29,halloween: the curse of michael myers,5000000,15126948,15126948,10126948,True
4298,99,1954-08-24,the egyptian,5000000,15000000,15000000,10000000,True
4299,100,1997-11-07,eve's bayou,5000000,14843425,14843425,9843425,True
4300,1,1981-04-10,nighthawks,5000000,14600000,19600000,14600000,True
4301,2,1989-07-28,friday the 13th part viii: jason takes manhattan,5000000,14343976,14343976,9343976,True
4302,3,2013-03-15,spring breakers,5000000,14124286,31149251,26149251,True
4303,4,2017-06-09,it comes at night,5000000,13985117,19720203,14720203,True
4304,5,2002-03-15,y tu mamã¡ tambiã©n,5000000,13649881,33649881,28649881,True
4305,6,2004-09-24,shaun of the dead,5000000,13542874,30332385,25332385,True
4306,7,2008-10-31,the haunting of molly hartley,5000000,13442412,15318257,10318257,True
4307,8,2016-07-15,hillaryâs america: the secret history of the democratic party,5000000,13099931,13099931,8099931,True
4308,9,1996-06-21,lone star,5000000,12961389,12961389,7961389,True
4309,10,1986-03-27,april fool's day,5000000,12947763,12947763,7947763,True
4310,11,1982-04-02,diner,5000000,12592907,12592907,7592907,True
4311,12,2017-03-03,before i fall,5000000,12241072,18945682,13945682,True
4312,13,1983-04-15,lone wolf mcquade,5000000,12232628,12232628,7232628,True
4313,14,2009-03-13,sunshine cleaning,5000000,12062558,17329337,12329337,True
4314,15,2016-01-29,fifty shades of black,5000000,11686940,22113075,17113075,True
4315,16,1957-12-14,a farewell to arms,5000000,11000000,11017403,6017403,True
4316,17,1959-01-01,solomon and sheba,5000000,11000000,11014961,6014961,True
4317,18,1982-08-20,the beastmaster,5000000,10751126,10751126,5751126,True
4318,19,2009-01-09,not easily broken,5000000,10572742,10732909,5732909,True
4319,20,2014-05-09,momsâ night out,5000000,10429707,10537341,5537341,True
4320,21,2017-03-17,the belko experiment,5000000,10166820,11792942,6792942,True
4321,22,2016-03-11,the perfect match,5000000,9669521,10182050,5182050,True
4322,23,2000-10-06,digimon: the movie,5000000,9628751,16628751,11628751,True
4323,24,2004-05-28,saved!,5000000,8886160,10206551,5206551,True
4324,25,2003-05-09,les invasions barbares,5000000,8460000,25913869,20913869,True
4325,26,1976-03-11,robin and marian,5000000,8000000,8000000,3000000,True
4326,27,1978-12-22,force 10 from navarone,5000000,7100000,7100000,2100000,True
4327,28,2001-04-27,the forsaken,5000000,6755271,6755271,1755271,True
4328,29,2018-09-21,fahrenheit 11/9,5000000,6352306,6653715,1653715,True
4329,30,1989-07-21,uhf,5000000,6157157,6157157,1157157,True
4330,31,2010-05-28,sea rex 3d: journey to a prehistoric world,5000000,6096582,16515203,11515203,True
4331,32,2006-01-06,grandmaâs boy,5000000,6090172,6590172,1590172,True
4332,33,1998-08-14,slums of beverly hills,5000000,5502773,5502773,502773,True
4333,34,1969-05-28,once upon a time in the west,5000000,5321508,5378425,378425,True
4334,35,2001-07-13,made,5000000,5308707,5476060,476060,True
4335,36,2004-11-19,la mala educaciã³n,5000000,5211842,40311842,35311842,True
4336,37,2009-06-12,moon,5000000,5010163,10676073,5676073,True
4337,38,2015-09-11,90 minutes in heaven,5000000,4816142,4816142,-183858,False
4338,39,2016-12-02,incarnate,5000000,4799774,9371036,4371036,False
4339,40,2006-05-12,keeping up with the steins,5000000,4339241,4414753,-585247,False
4340,41,1997-10-10,the sweet hereafter,5000000,4306697,7951247,2951247,False
4341,42,2008-08-06,bottle shock,5000000,4078607,4815890,-184110,False
4342,43,2011-02-25,des hommes et des dieux,5000000,3954651,46263525,41263525,False
4343,44,1982-08-27,jekyll and hyde... together again,5000000,3707583,3707583,-1292417,False
4344,45,2017-03-03,table 19,5000000,3614896,4620399,-379601,False
4345,46,2016-04-15,green room,5000000,3220371,3807503,-1192497,False
4346,47,2018-03-09,thoroughbreds,5000000,3072605,3187302,-1812698,False
4347,48,1994-11-16,heavenly creatures,5000000,3046086,5438120,438120,False
4348,49,2016-03-04,the other side of the door,5000000,3000342,12905107,7905107,False
4349,50,2011-05-13,everything must go,5000000,2712131,2821010,-2178990,False
4350,51,2014-10-10,kill the messenger,5000000,2450846,6656705,1656705,False
4351,52,2010-12-17,rabbit hole,5000000,2229058,6205034,1205034,False
4352,53,2015-10-23,jem and the holograms,5000000,2184640,2368937,-2631063,False
4353,54,2016-12-28,paterson,5000000,2141423,10727536,5727536,False
4354,55,1998-01-30,zero effect,5000000,2080693,2080693,-2919307,False
4355,56,1992-04-24,a midnight clear,5000000,1526697,1526697,-3473303,False
4356,57,2004-10-22,the machinist,5000000,1082044,8655397,3655397,False
4357,58,1992-09-21,light sleeper,5000000,1050861,1050861,-3949139,False
4358,59,2008-07-25,american teen,5000000,942441,989319,-4010681,False
4359,60,2014-09-12,atlas shrugged: who is john galt?,5000000,851690,851690,-4148310,False
4360,61,2003-08-29,party monster,5000000,742898,894030,-4105970,False
4361,62,2006-07-14,the oh in ohio,5000000,418689,648183,-4351817,False
4362,63,1996-02-21,bottle rocket,5000000,407488,407488,-4592512,False
4363,64,2013-08-16,ain't them bodies saints,5000000,391611,1075009,-3924991,False
4364,65,1997-01-17,albino alligator,5000000,353480,353480,-4646520,False
4365,66,2014-09-26,jimi: all is by my side,5000000,340911,927074,-4072926,False
4366,67,2007-08-03,"gandhi, my father",5000000,240425,2015004,-2984996,False
4367,68,2008-04-25,standard operating procedure,5000000,228830,332120,-4667880,False
4368,69,2011-09-30,tucker & dale vs. evil,5000000,223838,5476793,476793,False
4369,70,1998-03-27,no looking back,5000000,143273,143273,-4856727,False
4370,71,2015-08-07,cop car,5000000,134552,143658,-4856342,False
4371,72,2010-09-10,"lovely, still",5000000,127564,282687,-4717313,False
4372,73,2003-06-13,tycoon,5000000,121016,121016,-4878984,False
4373,74,1999-06-04,desert blue,5000000,99147,99147,-4900853,False
4374,75,2004-02-27,decoys,5000000,84733,96760,-4903240,False
4375,76,2008-05-30,stuck,5000000,67505,67505,-4932495,False
4376,77,2007-11-16,redacted,5000000,65388,861325,-4138675,False
4377,78,2014-10-17,rudderless,5000000,56001,567219,-4432781,False
4378,79,2005-01-28,fascination,5000000,16670,83356,-4916644,False
4379,80,2009-08-14,grace,5000000,8297,8297,-4991703,False
4380,81,2015-05-15,area 51,5000000,7556,7556,-4992444,False
4381,82,2012-10-26,mientras duermes,5000000,0,9109597,4109597,False
4382,83,2009-07-07,flying by,5000000,0,4568257,-431743,False
4383,84,2008-12-31,the cottage,5000000,0,1504960,-3495040,False
4384,85,2014-12-05,dying of the light,5000000,0,74639,-4925361,False
4385,86,2016-09-02,yoga hosers,5000000,0,22958,-4977042,False
4386,87,2009-02-17,dead like me: life after death,5000000,0,0,-5000000,False
4387,88,2007-01-30,farce of the penguins,5000000,0,0,-5000000,False
4388,89,2010-12-31,psych 9,5000000,0,0,-5000000,False
4389,90,2014-11-21,reach me,5000000,0,0,-5000000,False
4390,91,2014-08-18,henry & me,5000000,0,0,-5000000,False
4391,92,2015-01-27,born of war,5000000,0,0,-5000000,False
4392,93,2015-01-09,let's kill ward's wife,5000000,0,0,-5000000,False
4393,94,2015-01-13,capricorn one,5000000,0,0,-5000000,False
4394,95,2011-12-31,we have your husband,5000000,0,0,-5000000,False
4395,96,2012-12-31,should've been romeo,5000000,0,0,-5000000,False
4396,97,2015-12-31,aztec warrior,5000000,0,0,-5000000,False
4397,98,2015-09-25,navy seal vs. zombies,5000000,0,0,-5000000,False
4398,99,2016-03-15,the hatching,5000000,0,0,-5000000,False
4399,100,2015-10-27,running forever,5000000,0,0,-5000000,False
4400,1,2015-01-23,mommy,4900000,3498695,17536004,12636004,False
4401,2,2008-08-29,obsluhoval jsem anglickã©ho krã¡le,4900000,617228,7174984,2274984,False
4402,3,2010-08-20,soul kitchen,4900000,276901,23347461,18447461,False
4403,4,2012-08-17,the awakening,4900000,95933,6924321,2024321,False
4404,5,2008-01-18,all hat,4900000,15198,15198,-4884802,False
4405,6,1996-11-20,sling blade,4833610,24475416,34175000,29341390,True
4406,7,2006-01-06,hostel,4800000,47326473,82241110,77441110,True
4407,8,2013-07-19,only god forgives,4800000,775849,4494560,-305440,False
4408,9,2011-09-30,take shelter,4750000,1728953,4972016,222016,False
4409,10,2006-01-27,tristram shandy: a cock and bull story,4750000,1253413,3061763,-1688237,False
4410,11,1986-08-22,the texas chainsaw massacre 2,4700000,8025872,8025872,3325872,True
4411,12,1988-04-22,lady in white,4700000,1705139,1705139,-2994861,False
4412,13,2006-10-13,driving lessons,4700000,239962,239962,-4460038,False
4413,14,2011-12-31,without men,4700000,0,0,-4700000,False
4414,15,2015-03-10,treading water,4700000,0,0,-4700000,False
4415,16,1973-05-23,pat garrett and billy the kid,4638783,8000000,11000000,6361217,True
4416,17,2004-07-16,camping sauvage,4600000,3479302,3479302,-1120698,False
4417,18,2012-09-14,barfi,4600000,2804874,36751984,32151984,False
4418,19,2005-03-04,dear frankie,4600000,1340891,3099369,-1500631,False
4419,20,2004-12-29,the assassination of richard nixon,4600000,708776,4880143,280143,False
4420,21,2011-06-24,le nom des gens,4600000,514237,9261711,4661711,False
4421,22,2008-05-28,savage grace,4600000,434417,968805,-3631195,False
4422,23,2007-10-19,out of the blue,4600000,728,731767,-3868233,False
4423,24,1984-03-23,police academy,4500000,81198894,81198894,76698894,True
4424,25,1994-03-09,four weddings and a funeral,4500000,52700832,242895809,238395809,True
4425,26,1980-06-20,the blue lagoon,4500000,47923795,47923795,43423795,True
4426,27,1982-08-13,fast times at ridgemont high,4500000,27092880,27092880,22592880,True
4427,28,1996-09-28,secrets & lies,4500000,13417292,13417292,8917292,True
4428,29,2002-12-19,25th hour,4500000,13084595,25344490,20844490,True
4429,30,1985-09-13,after hours,4500000,10609321,10609321,6109321,True
4430,31,1956-06-27,moby dick,4500000,10400000,10400000,5900000,True
4431,32,2016-03-25,the lobster,4500000,9196278,18019834,13519834,True
4432,33,1996-10-04,bound,4500000,3802260,7011317,2511317,False
4433,34,2000-10-06,requiem for a dream,4500000,3635482,7389233,2889233,False
4434,35,1962-03-09,state fair,4500000,3500000,3500000,-1000000,False
4435,36,2008-10-24,lã¥t den rã¤tte komma in,4500000,2122085,12247682,7747682,False
4436,37,1999-02-12,tango,4500000,1687311,5428387,928387,False
4437,38,1986-04-23,salvador,4500000,1500000,1500000,-3000000,False
4438,39,2001-10-26,donnie darko,4500000,1480006,7510877,3010877,False
4439,40,2011-09-02,salvando al soldado perez,4500000,1400726,9330465,4830465,False
4440,41,1998-03-27,karakter,4500000,713413,713413,-3786587,False
4441,42,2011-08-19,nannerl la soeur de mozart,4500000,707885,2404639,-2095361,False
4442,43,2003-03-14,spun,4500000,410241,1022649,-3477351,False
4443,44,2010-07-23,life during wartime,4500000,281447,281447,-4218553,False
4444,45,2006-05-04,chinjeolhan geumjassi,4500000,211667,23471871,18971871,False
4445,46,2011-10-07,blackthorn,4500000,200558,1217307,-3282693,False
4446,47,2015-05-08,maggie,4500000,187112,1027760,-3472240,False
4447,48,2003-04-18,lilja 4-ever,4500000,181655,4556982,56982,False
4448,49,2010-04-09,after.life,4500000,108596,2481925,-2018075,False
4449,50,2002-02-22,mean machine,4500000,92723,92723,-4407277,False
4450,51,2007-08-31,fong juk,4500000,51957,51957,-4448043,False
4451,52,2010-07-23,spoken word,4500000,32961,32961,-4467039,False
4452,53,2013-03-01,the sweeney,4500000,26345,8000366,3500366,False
4453,54,2014-09-04,falcon rising,4500000,11774,11774,-4488226,False
4454,55,2013-06-25,hansel & gretel get baked,4500000,0,0,-4500000,False
4455,56,2014-11-07,fugly,4500000,0,0,-4500000,False
4456,57,2015-08-28,zipper,4500000,0,0,-4500000,False
4457,58,2015-11-03,the final girls,4500000,0,0,-4500000,False
4458,59,2017-12-01,daisy winters,4500000,0,0,-4500000,False
4459,60,1975-11-19,one flew over the cuckoo's nest,4400000,108981275,108997629,104597629,True
4460,61,1976-06-25,silent movie,4400000,36145695,36145695,31745695,True
4461,62,2016-12-31,airlift (2016),4400000,0,9969237,5569237,False
4462,63,2015-09-29,r.l. stine's monsterville: the cabinet of souls,4400000,0,0,-4400000,False
4463,64,2014-06-06,anna,4357373,0,1200000,-3157373,False
4464,65,2003-06-06,whale rider,4300000,20779666,39374600,35074600,True
4465,66,2001-06-13,sexy beast,4300000,6946056,10158355,5858355,True
4466,67,2009-12-04,paa,4300000,199228,9791282,5491282,False
4467,68,2012-07-11,snabba cash,4300000,188870,10212403,5912403,False
4468,69,1990-10-19,night of the living dead,4200000,5835247,5835247,1635247,True
4469,70,2006-02-17,nochnoy dozor,4200000,1502188,33913542,29713542,False
4470,71,2010-08-13,animal kingdom,4200000,1044039,8078683,3878683,False
4471,72,2010-05-28,george a. romero's survival of the dead,4200000,101740,101740,-4098260,False
4472,73,2011-10-21,cargo,4200000,0,313230,-3886770,False
4473,74,2006-05-23,high school musical,4200000,0,0,-4200000,False
4474,75,1998-03-06,love and death on long island,4030000,2542264,2542264,-1487736,False
4475,76,1982-03-19,porky's,4000000,109492484,109492484,105492484,True
4476,77,1953-02-05,peter pan,4000000,87400000,87400000,83400000,True
4477,78,1992-11-25,the crying game,4000000,62546695,62546695,58546695,True
4478,79,2003-09-12,lost in translation,4000000,44585453,117085297,113085297,True
4479,80,1977-04-20,annie hall,4000000,38251425,38251425,34251425,True
4480,81,2015-01-23,the boy next door,4000000,36006065,53401938,49401938,True
4481,82,1952-01-10,the greatest show on earth,4000000,36000000,36000000,32000000,True
4482,83,1995-10-27,leaving las vegas,4000000,31983777,49800000,45800000,True
4483,84,2001-12-26,monster's ball,4000000,31273922,43766463,39766463,True
4484,85,2014-07-11,boyhood,4000000,25379975,57273049,53273049,True
4485,86,1960-12-15,exodus,4000000,21750000,21750000,17750000,True
4486,87,2010-07-09,the kids are all right,4000000,20811365,36275469,32275469,True
4487,88,1979-08-17,life of brian,4000000,20182359,20468305,16468305,True
4488,89,2014-04-18,a haunted house 2,4000000,17329487,21206861,17206861,True
4489,90,2013-03-01,the last exorcism part ii,4000000,15179303,25448707,21448707,True
4490,91,1974-12-17,the front page,4000000,15000000,15000000,11000000,True
4491,92,1956-05-30,trapeze,4000000,14400000,14400000,10400000,True
4492,93,1985-08-16,the return of the living dead,4000000,14237880,14237880,10237880,True
4493,94,1988-11-04,they live,4000000,13000000,13000774,9000774,True
4494,95,2000-08-04,saving grace,4000000,12178602,27786849,23786849,True
4495,96,1963-08-08,the great escape,4000000,11744471,11972561,7972561,True
4496,97,2004-02-06,what the #$'! do we know,4000000,10941801,10941801,6941801,True
4497,98,2016-05-13,the darkness,4000000,10753574,10898293,6898293,True
4498,99,2006-07-28,scoop,4000000,10525717,40103262,36103262,True
4499,100,2001-11-14,the wash,4000000,10097096,10097096,6097096,True
4500,1,2000-03-01,3 strikes,4000000,9821335,9821335,5821335,True
4501,2,2008-04-11,the visitor,4000000,9427026,19174817,15174817,True
4502,3,2003-11-26,the cooler,4000000,8291572,11131455,7131455,True
4503,4,1961-02-01,the misfits,4000000,8200000,8200000,4200000,True
4504,5,2006-08-04,the night listener,4000000,7836393,10770993,6770993,True
4505,6,1995-02-03,the jerky boys,4000000,7555256,7555256,3555256,True
4506,7,2007-12-28,el orfanato,4000000,7159147,79250193,75250193,True
4507,8,2007-05-25,bug,4000000,7006708,8302995,4302995,True
4508,9,2002-10-11,the rules of attraction,4000000,6525762,11799060,7799060,True
4509,10,1969-12-19,topaz,4000000,6000000,6000000,2000000,True
4510,11,2006-11-17,let's go to prison,4000000,4630045,4630045,630045,True
4511,12,1995-12-25,four rooms,4000000,4301000,4301000,301000,True
4512,13,2002-09-20,secretary,4000000,4046737,9413956,5413956,True
4513,14,2003-04-25,the real cancun,4000000,3816594,3816594,-183406,False
4514,15,1988-12-01,talk radio,4000000,3468572,3468572,-531428,False
4515,16,1997-01-31,waiting for guffman,4000000,2922988,2922988,-1077012,False
4516,17,1999-09-10,love stinks,4000000,2793776,2793776,-1206224,False
4517,18,2012-08-24,samsara,4000000,2672413,5966671,1966671,False
4518,19,2007-06-22,you kill me,4000000,2426851,3858964,-141036,False
4519,20,2011-06-17,the art of getting by,4000000,1430241,1989035,-2010965,False
4520,21,2005-09-16,thumbsucker,4000000,1328679,1919197,-2080803,False
4521,22,2011-09-23,red state,4000000,1065429,1983596,-2016404,False
4522,23,2005-09-30,mirrormask,4000000,864959,973613,-3026387,False
4523,24,1987-03-31,the barbarians,4000000,800000,800000,-3200000,False
4524,25,2012-10-17,holy motors,4000000,641054,4230426,230426,False
4525,26,2014-06-13,the signal,4000000,600896,2665322,-1334678,False
4526,27,2003-02-28,poolhall junkies,4000000,563711,563711,-3436289,False
4527,28,1999-05-28,the loss of sexual innocence,4000000,399793,399793,-3600207,False
4528,29,2014-03-07,the face of love,4000000,385069,1158877,-2841123,False
4529,30,2014-04-11,joe,4000000,373375,373375,-3626625,False
4530,31,1988-03-04,prison,4000000,354704,354704,-3645296,False
4531,32,1998-05-01,shooting fish,4000000,302204,302204,-3697796,False
4532,33,2009-05-08,adoration,4000000,294244,384244,-3615756,False
4533,34,2000-08-04,psycho beach party,4000000,267972,267972,-3732028,False
4534,35,2019-06-07,late night,4000000,246305,246305,-3753695,False
4535,36,2000-01-28,the big tease,4000000,185577,185577,-3814423,False
4536,37,2017-08-25,polina danser sa vie,4000000,165203,953314,-3046686,False
4537,38,2015-04-10,desert dancer,4000000,155271,596335,-3403665,False
4538,39,2015-01-30,"guten tag, ramon",4000000,154356,4854356,854356,False
4539,40,2003-07-25,mondays in the sun,4000000,146402,146402,-3853598,False
4540,41,2015-06-19,manglehorn,4000000,132270,797439,-3202561,False
4541,42,2010-04-02,tau ming chong,4000000,129078,38899792,34899792,False
4542,43,2011-04-01,trust,4000000,120016,120016,-3879984,False
4543,44,2000-12-22,an everlasting piece,4000000,75078,75078,-3924922,False
4544,45,1999-03-26,among giants,4000000,64359,64359,-3935641,False
4545,46,1999-07-16,the velocity of gary,4000000,34145,34145,-3965855,False
4546,47,2011-04-22,stake land,4000000,33245,679482,-3320518,False
4547,48,2015-02-27,praia do futuro,4000000,20620,760678,-3239322,False
4548,49,2002-12-27,sonny,4000000,17639,17639,-3982361,False
4549,50,1997-06-20,the last time i committed suicide,4000000,12836,12836,-3987164,False
4550,51,2014-04-18,13 sins,4000000,9134,47552,-3952448,False
4551,52,2011-11-18,another happy day,4000000,9120,978527,-3021473,False
4552,53,2013-02-22,inescapable,4000000,4327,4327,-3995673,False
4553,54,2017-12-31,perfectos desconocidos,4000000,0,31166312,27166312,False
4554,55,2013-12-31,geograf globus propil,4000000,0,4454853,454853,False
4555,56,2012-03-20,a lonely place to die,4000000,0,442550,-3557450,False
4556,57,2003-12-31,nothing,4000000,0,63180,-3936820,False
4557,58,2012-06-01,the loved ones,4000000,0,12302,-3987698,False
4558,59,1972-11-09,1776,4000000,0,0,-4000000,False
4559,60,1930-11-15,hell's angels,4000000,0,0,-4000000,False
4560,61,2008-08-26,purple violets,4000000,0,0,-4000000,False
4561,62,2012-11-09,replicas,4000000,0,0,-4000000,False
4562,63,2012-12-31,the helpers,4000000,0,0,-4000000,False
4563,64,2015-12-31,the veil,4000000,0,0,-4000000,False
4564,65,2014-07-11,the perfect wave,4000000,0,0,-4000000,False
4565,66,2012-12-31,how to fall in love,4000000,0,0,-4000000,False
4566,67,2015-09-08,chain of command,4000000,0,0,-4000000,False
4567,68,1939-12-15,gone with the wind,3900000,198680470,390525192,386625192,True
4568,69,1966-12-12,a man for all seasons,3900000,28350000,28350000,24450000,True
4569,70,1925-12-30,ben-hur: a tale of the christ,3900000,9000000,9000000,5100000,True
4570,71,1976-01-01,network,3800000,23689877,23689877,19889877,True
4571,72,2011-01-14,down for life,3800000,41914,41914,-3758086,False
4572,73,2010-04-30,the good heart,3800000,20930,340930,-3459070,False
4573,74,1965-04-07,major dundee,3800000,14873,14873,-3785127,False
4574,75,2018-10-05,hevi reissu,3800000,10153,10153,-3789847,False
4575,76,1974-12-31,the taking of pelham one two three,3800000,0,0,-3800000,False
4576,77,1950-05-17,annie get your gun,3768785,8000000,8000000,4231215,True
4577,78,2006-08-11,casa de areia,3750000,539285,1178175,-2571825,False
4578,79,2010-11-05,four lions,3750000,310007,2436111,-1313889,False
4579,80,2010-02-19,defendor,3750000,44462,44462,-3705538,False
4580,81,1970-05-13,the ballad of cable hogue,3716946,3500000,5000000,1283054,False
4581,82,1948-05-20,the pirate,3700000,2956000,2956000,-744000,False
4582,83,2006-11-21,the history boys,3700000,2730296,13447998,9747998,False
4583,84,2006-11-03,unknown,3700000,26403,3355048,-344952,False
4584,85,1969-05-25,midnight cowboy,3600000,44785053,44785053,41185053,True
4585,86,2008-10-10,billy: the early years of billy graham,3600000,320896,320896,-3279104,False
4586,87,2017-12-31,utã¸ya 22. juli,3600000,0,173156,-3426844,False
4587,88,1980-07-04,airplane!,3500000,83453539,83453539,79953539,True
4588,89,1970-01-01,m*a*s*h,3500000,81600000,81600000,78100000,True
4589,90,1997-08-13,the full monty,3500000,45950122,261249383,257749383,True
4590,91,2018-04-13,truth or dare,3500000,41411015,95127344,91627344,True
4591,92,1993-05-26,menace ii society,3500000,27731527,27731527,24231527,True
4592,93,1995-04-26,friday,3500000,27467564,27936778,24436778,True
4593,94,2016-02-19,the witch,3500000,25138705,40454520,36954520,True
4594,95,2018-02-02,winchester,3500000,25091816,44378040,40878040,True
4595,96,2002-12-06,empire,3500000,17504595,18495444,14995444,True
4596,97,2013-02-22,dark skies,3500000,17418667,27704111,24204111,True
4597,98,2018-01-19,forever my girl,3500000,16376066,16376066,12876066,True
4598,99,1987-05-01,creepshow 2,3500000,14000000,14000000,10500000,True
4599,100,1967-12-14,in cold blood,3500000,13000000,13007551,9507551,True
4600,1,1959-07-18,the nun's story,3500000,12800000,12800000,9300000,True
4601,2,1972-06-21,frenzy,3500000,12600000,12600000,9100000,True
4602,3,1966-02-23,harper,3500000,12000000,12000000,8500000,True
4603,4,1998-05-27,i got the hook-up!,3500000,10317779,10317779,6817779,True
4604,5,1996-08-23,she's the one,3500000,9482579,13795053,10295053,True
4605,6,1980-01-01,terror train,3500000,8000000,8000000,4500000,True
4606,7,1998-11-06,gods and monsters,3500000,6451628,6451628,2951628,True
4607,8,2010-04-16,el secreto de sus ojos,3500000,6391436,40527719,37027719,True
4608,9,1987-03-13,evil dead ii,3500000,5923044,5926177,2426177,True
4609,10,1985-06-30,day of the dead,3500000,5804262,34004262,30504262,True
4610,11,2018-05-18,first reformed,3500000,3448256,3874772,374772,False
4611,12,2001-06-29,pootie tang,3500000,3293258,3293258,-206742,False
4612,13,2016-12-02,believe,3500000,890303,890303,-2609697,False
4613,14,2000-04-19,la otra conquista,3500000,886410,886410,-2613590,False
4614,15,2016-09-30,american honey,3500000,663247,2611750,-888250,False
4615,16,2016-03-18,the bronze,3500000,615816,615816,-2884184,False
4616,17,2011-06-10,trolljegeren,3500000,253444,5706638,2206638,False
4617,18,2007-09-14,ira and abby,3500000,221096,221096,-3278904,False
4618,19,2016-01-08,the masked saint,3500000,182695,182695,-3317305,False
4619,20,2006-02-17,winter passing,3500000,107492,113783,-3386217,False
4620,21,2005-03-25,d.e.b.s.,3500000,96793,96793,-3403207,False
4621,22,2016-06-03,time to choose,3500000,29233,29233,-3470767,False
4622,23,2009-06-26,surveillance,3500000,27349,1396395,-2103605,False
4623,24,1999-09-17,taxman,3500000,9871,9871,-3490129,False
4624,25,2011-12-31,the kick,3500000,0,40622,-3459378,False
4625,26,2009-06-30,the betrayed,3500000,0,0,-3500000,False
4626,27,2006-10-01,the secret,3500000,0,0,-3500000,False
4627,28,2011-06-28,2:13,3500000,0,0,-3500000,False
4628,29,2013-01-29,"batman: the dark knight returns, part 2",3500000,0,0,-3500000,False
4629,30,2014-03-11,in the name of the king iii,3500000,0,0,-3500000,False
4630,31,2014-03-04,wicked blood,3500000,0,0,-3500000,False
4631,32,2015-06-05,dawn patrol,3500000,0,0,-3500000,False
4632,33,2013-05-17,jagten,3450000,687185,18309793,14859793,False
4633,34,2015-09-01,lords of london,3440000,0,0,-3440000,False
4634,35,2005-06-24,la marche de l'empereur,3400000,77437223,133276359,129876359,True
4635,36,1977-12-23,high anxiety,3400000,31063038,31063038,27663038,True
4636,37,2011-10-21,margin call,3400000,5353586,20433227,17033227,True
4637,38,2008-09-26,choke,3400000,2926565,4124277,724277,False
4638,39,2004-04-23,l\'incomparable mademoiselle c.,3400000,493905,493905,-2906095,False
4639,40,2008-07-11,august,3400000,12636,12636,-3387364,False
4640,41,2015-03-03,to write love on her arms,3400000,0,0,-3400000,False
4641,42,1956-02-16,carousel,3380000,0,3604,-3376396,False
4642,43,2014-10-10,whiplash,3300000,13092006,38969037,35669037,True
4643,44,2007-10-26,bella,3300000,8093373,12405473,9105473,True
4644,45,2003-01-17,cidade de deus,3300000,7563397,32059295,28759295,True
4645,46,2000-05-05,human traffic,3300000,104257,5422740,2122740,False
4646,47,2006-12-29,the dead girl,3300000,19875,19875,-3280125,False
4647,48,2015-01-20,the opposite sex,3300000,0,50206,-3249794,False
4648,49,1983-11-18,a christmas story,3250000,20605209,20605209,17355209,True
4649,50,1982-08-20,class of 1984,3250000,6965361,6965361,3715361,True
4650,51,2009-01-30,entre les murs,3250000,3766810,34114067,30864067,True
4651,52,1999-10-29,dreaming of joseph lees,3250000,7680,7680,-3242320,False
4652,53,1968-06-12,rosemary's baby,3200000,33395426,33395426,30195426,True
4653,54,2018-07-06,sorry to bother you,3200000,17493096,18285560,15085560,True
4654,55,1962-04-22,the man who shot liberty valance,3200000,8000000,8000000,4800000,True
4655,56,2004-07-16,maria full of grace,3200000,6529624,14441158,11241158,True
4656,57,2011-06-03,beginners,3200000,5790894,14314407,11114407,True
4657,58,2016-04-22,the meddler,3200000,4267219,5526942,2326942,True
4658,59,2009-07-29,adam,3200000,2283291,2834485,-365515,False
4659,60,2006-09-22,feast,3200000,56131,690872,-2509128,False
4660,61,1946-12-20,itâs a wonderful life,3180000,6600000,10768908,7588908,True
4661,62,1996-07-19,trainspotting,3100000,16501785,71558971,68458971,True
4662,63,2013-04-12,antiviral,3100000,0,123407,-2976593,False
4663,64,1978-07-28,national lampoon's animal house,3000000,141600000,141600000,138600000,True
4664,65,2010-10-20,paranormal activity 2,3000000,84752907,177512032,174512032,True
4665,66,2015-08-28,war room,3000000,67790117,73975239,70975239,True
4666,67,2013-06-07,the purge,3000000,64473115,91266581,88266581,True
4667,68,1964-12-22,goldfinger,3000000,51100000,124900000,121900000,True
4668,69,2012-10-12,sinister,3000000,48086903,87727807,84727807,True
4669,70,2000-08-18,the original kings of comedy,3000000,38168022,38236338,35236338,True
4670,71,1957-12-18,the bridge on the river kwai,3000000,33300000,33300000,30300000,True
4671,72,1978-01-01,coming home,3000000,32653000,32653000,29653000,True
4672,73,1998-11-20,waking ned devine,3000000,24793251,55193251,52193251,True
4673,74,1997-08-01,air bud,3000000,24646936,27788649,24788649,True
4674,75,2002-10-11,bowling for columbine,3000000,21576018,58240487,55240487,True
4675,76,1985-11-01,a nightmare on elm street part 2: freddy's revenge,3000000,21163999,21163999,18163999,True
4676,77,1986-03-07,a room with a view,3000000,20966644,20966644,17966644,True
4677,78,1975-06-10,love and death,3000000,20123742,20123742,17123742,True
4678,79,1986-08-01,friday the 13th part vi: jason lives,3000000,19472057,19472057,16472057,True
4679,80,2002-08-02,martin lawrence live: runteldat,3000000,19184820,19184820,16184820,True
4680,81,1960-06-15,the apartment,3000000,18600000,24600000,21600000,True
4681,82,1958-09-20,cat on a hot tin roof,3000000,17570324,17570324,14570324,True
4682,83,1970-05-26,beneath the planet of the apes,3000000,17489009,17489009,14489009,True
4683,84,2001-04-06,pokemon 3: the movie,3000000,17052128,68452128,65452128,True
4684,85,1993-08-13,jason goes to hell: the final friday,3000000,15935068,15935068,12935068,True
4685,86,1990-04-27,spaced invaders,3000000,15000000,15000000,12000000,True
4686,87,1976-04-09,family plot,3000000,13200000,13200000,10200000,True
4687,88,1966-07-16,torn curtain,3000000,13000000,13000000,10000000,True
4688,89,2018-06-01,upgrade,3000000,11977130,16553285,13553285,True
4689,90,2006-03-03,dave chappelle's block party,3000000,11718595,12051924,9051924,True
4690,91,1985-10-25,krush groove,3000000,11052713,11052713,8052713,True
4691,92,1960-07-07,elmer gantry,3000000,10400000,10400000,7400000,True
4692,93,2009-05-08,next day air,3000000,10027047,10172519,7172519,True
4693,94,1961-12-19,judgment at nuremberg,3000000,10000000,10000000,7000000,True
4694,95,1998-11-04,belly,3000000,9639390,9639390,6639390,True
4695,96,1999-05-12,trippinâ,3000000,9017070,9017070,6017070,True
4696,97,1948-08-26,red river,3000000,9012000,9012000,6012000,True
4697,98,2001-08-08,the deep end,3000000,8823109,9981635,6981635,True
4698,99,2013-05-24,before midnight,3000000,8110621,23251930,20251930,True
4699,100,1987-11-20,teen wolf too,3000000,7888000,7888000,4888000,True
4700,1,2009-07-31,the collector,3000000,7712114,10473836,7473836,True
4701,2,1988-07-08,phantasm ii,3000000,7282851,7282851,4282851,True
4702,3,2017-10-27,let there be light,3000000,7233471,7241309,4241309,True
4703,4,2006-04-07,phat girlz,3000000,7061128,7301115,4301115,True
4704,5,2004-10-01,woman thou art loosed,3000000,6879730,6879730,3879730,True
4705,6,2002-10-18,real women have curves,3000000,5853194,7777790,4777790,True
4706,7,1981-08-28,gallipoli,3000000,5732587,5732587,2732587,True
4707,8,2006-04-28,water,3000000,5529144,11322573,8322573,True
4708,9,2016-07-22,donât think twice,3000000,4417983,4417983,1417983,True
4709,10,2016-06-24,swiss army man,3000000,4210454,5837111,2837111,True
4710,11,2000-04-14,east is east,3000000,4170647,30438635,27438635,True
4711,12,2000-09-01,whipped,3000000,4142507,4142507,1142507,True
4712,13,1997-02-28,kama sutra,3000000,4109095,4109095,1109095,True
4713,14,2013-05-17,frances ha,3000000,4067398,11262769,8262769,True
4714,15,2010-04-30,please give,3000000,4033574,4570178,1570178,True
4715,16,1971-06-30,willy wonka & the chocolate factory,3000000,4000000,4000000,1000000,True
4716,17,1993-09-24,warlock: the armageddon,3000000,3902679,3902679,902679,True
4717,18,1997-04-18,8 heads in a duffel bag,3000000,3602884,4002884,1002884,True
4718,19,1978-09-13,days of heaven,3000000,3446749,3660880,660880,True
4719,20,2002-05-24,thirteen conversations about one thing,3000000,3287435,3705923,705923,True
4720,21,2016-04-22,compadres,3000000,3127773,7445044,4445044,True
4721,22,1999-02-19,jawbreaker,3000000,3076820,3076820,76820,True
4722,23,1996-08-09,basquiat,3000000,2962051,2962051,-37949,False
4723,24,2006-02-24,tsotsi,3000000,2912606,11537539,8537539,False
4724,25,2010-04-09,letters to god,3000000,2848587,3237452,237452,False
4725,26,1998-10-16,happiness,3000000,2746453,5746453,2746453,False
4726,27,2003-04-04,dysfunktional family,3000000,2255000,2255000,-745000,False
4727,28,2014-09-19,tusk,3000000,1821983,1887554,-1112446,False
4728,29,2017-05-12,the wall,3000000,1803064,4495262,1495262,False
4729,30,2003-10-24,elephant,3000000,1266955,10051516,7051516,False
4730,31,2012-04-06,damsels in distress,3000000,1007535,1324299,-1675701,False
4731,32,2005-03-25,oldboy,3000000,707391,6239723,3239723,False
4732,33,2011-05-06,hobo with a shotgun,3000000,703372,834953,-2165047,False
4733,34,2015-05-08,the d train,3000000,669688,772366,-2227634,False
4734,35,2012-09-07,bachelorette,3000000,446770,12577401,9577401,False
4735,36,2010-01-15,fish tank,3000000,374675,5922292,2922292,False
4736,37,2008-09-05,everybody wants to be italian,3000000,351416,351416,-2648584,False
4737,38,2011-09-09,creature,3000000,331000,331000,-2669000,False
4738,39,2016-12-09,the bounce back,3000000,321910,421404,-2578596,False
4739,40,1996-08-23,freeway,3000000,295493,295493,-2704507,False
4740,41,2006-10-06,love's abiding joy,3000000,252726,252726,-2747274,False
4741,42,1993-02-12,dead alive,3000000,242623,242623,-2757377,False
4742,43,2010-10-01,chain letter,3000000,205842,1022453,-1977547,False
4743,44,2012-03-02,tim and eric's billion dollar movie,3000000,201436,223652,-2776348,False
4744,45,2007-11-09,holly,3000000,163069,163069,-2836931,False
4745,46,2010-03-26,the eclipse,3000000,133411,133411,-2866589,False
4746,47,2008-03-21,the grand,3000000,115879,115879,-2884121,False
4747,48,2006-03-17,sommersturm,3000000,95204,95204,-2904796,False
4748,49,2014-08-15,fort mccoy,3000000,78948,78948,-2921052,False
4749,50,1999-08-04,the gambler,3000000,51773,101773,-2898227,False
4750,51,2000-10-13,just looking,3000000,39852,39852,-2960148,False
4751,52,2015-09-04,before we go,3000000,37151,483938,-2516062,False
4752,53,2012-01-13,the divide,3000000,18000,156362,-2843638,False
4753,54,2011-09-09,tanner hall,3000000,5073,5073,-2994927,False
4754,55,2005-09-30,my big fat independent movie,3000000,4655,4655,-2995345,False
4755,56,2017-10-10,demonic,3000000,0,4668109,1668109,False
4756,57,2008-04-15,ã l\'intã©rieur,3000000,0,895932,-2104068,False
4757,58,2014-06-27,they came together,3000000,0,82780,-2917220,False
4758,59,2013-05-21,open road,3000000,0,47469,-2952531,False
4759,60,1951-07-28,alice in wonderland,3000000,0,0,-3000000,False
4760,61,2010-10-01,barry munday,3000000,0,0,-3000000,False
4761,62,2009-12-31,the deported,3000000,0,0,-3000000,False
4762,63,2009-12-31,chicago overcoat,3000000,0,0,-3000000,False
4763,64,2011-09-13,never back down 2: the beatdown,3000000,0,0,-3000000,False
4764,65,2015-12-31,awol-72,3000000,0,0,-3000000,False
4765,66,2013-01-15,30 nights of paranormal activity with the devil inside the girl with the dragon tattoo,3000000,0,0,-3000000,False
4766,67,2015-02-06,enter the dangerous mind,3000000,0,0,-3000000,False
4767,68,2015-03-17,something wicked,3000000,0,0,-3000000,False
4768,69,1967-09-18,point blank,3000000,0,0,-3000000,False
4769,70,2014-10-27,iguana,3000000,0,0,-3000000,False
4770,71,2009-12-31,four single fathers,3000000,0,0,-3000000,False
4771,72,2015-08-14,amnesiac,3000000,0,0,-3000000,False
4772,73,2015-12-31,unnatural,3000000,0,0,-3000000,False
4773,74,2015-12-11,close range,3000000,0,0,-3000000,False
4774,75,1946-01-18,the harvey girls,2931000,4100000,4100000,1169000,True
4775,76,1950-02-15,cinderella,2900000,85000000,263591415,260691415,True
4776,77,1998-11-20,central do brasil,2900000,5969553,17006158,14106158,True
4777,78,1961-12-19,pocketful of miracles,2900000,5000000,5000000,2100000,True
4778,79,2006-03-24,boynton beach club,2900000,3127472,3127472,227472,True
4779,80,2010-10-01,freakonomics,2900000,101270,172867,-2727133,False
4780,81,2011-08-19,griff the invisible,2900000,20778,25935,-2874065,False
4781,82,1959-03-29,some like it hot,2883848,25000000,25019542,22135694,True
4782,83,2005-06-10,high tension,2850000,3681066,6435262,3585262,True
4783,84,1974-12-15,young frankenstein,2800000,86300000,86300000,83500000,True
4784,85,1976-06-25,the omen,2800000,48570885,48570885,45770885,True
4785,86,2005-07-22,hustle & flow,2800000,22202809,23591783,20791783,True
4786,87,1988-05-13,friday the 13th part vii: the new blood,2800000,19170001,19170001,16370001,True
4787,88,2006-09-15,artie lange's beer league,2800000,475000,475000,-2325000,False
4788,89,1939-08-25,the wizard of oz,2777000,34063405,34305476,31528476,True
4789,90,2008-02-15,diary of the dead,2750000,952620,5394447,2644447,False
4790,91,1979-10-17,the black stallion,2700000,37799643,37799643,35099643,True
4791,92,1997-06-13,ulee's gold,2700000,9054736,15600000,12900000,True
4792,93,2018-10-26,indivisible,2700000,3511417,3588305,888305,True
4793,94,2006-09-01,lage raho munna bhai,2700000,2217561,31517561,28817561,False
4794,95,2015-12-31,sardaar ji,2700000,0,8200000,5500000,False
4795,96,2008-12-31,rejsen til saturn,2700000,0,5377665,2677665,False
4796,97,1963-06-12,donovan's reef,2686000,6600000,6600000,3914000,True
4797,98,1956-01-12,diane,2660000,0,0,-2660000,False
4798,99,1998-01-16,the dress,2650000,16556,16556,-2633444,False
4799,100,1943-12-24,a guy named joe,2627000,5363000,5363000,2736000,True
4800,1,1974-02-07,blazing saddles,2600000,119500000,119500000,116900000,True
4801,2,1984-04-13,friday the 13th part iv: the final chapter,2600000,32980880,32980880,30380880,True
4802,3,2014-05-02,ida,2600000,3827060,15298355,12698355,True
4803,4,1987-01-01,maurice,2600000,3147950,3198308,598308,True
4804,5,2004-07-09,riding giants,2600000,2276368,3292333,692333,False
4805,6,2008-12-12,los cronocrã­menes,2600000,39127,564474,-2035526,False
4806,7,2011-12-31,la cara oculta,2600000,0,7033931,4433931,False
4807,8,2007-12-07,timber falls,2600000,0,71248,-2528752,False
4808,9,2008-12-31,silver medalist,2600000,0,0,-2600000,False
4809,10,2011-04-01,"fat, sick & nearly dead",2600000,0,0,-2600000,False
4810,11,1952-04-10,singin' in the rain,2540000,7200000,7200000,4660000,True
4811,12,2013-01-11,a haunted house,2500000,40041683,59922558,57422558,True
4812,13,2012-07-13,2016: obamaâs america,2500000,33349941,33349941,30849941,True
4813,14,2013-07-03,kevin hart: let me explain,2500000,32244051,32327255,29827255,True
4814,15,2004-07-28,garden state,2500000,26782316,36028802,33528802,True
4815,16,1996-10-04,that thing you do!,2500000,25857416,34557416,32057416,True
4816,17,1981-10-30,halloween ii,2500000,25533818,25533818,23033818,True
4817,18,1982-10-22,halloween 3: season of the witch,2500000,14400000,14400000,11900000,True
4818,19,2008-10-01,religulous,2500000,13011160,13881317,11381317,True
4819,20,1971-01-01,escape from the planet of the apes,2500000,12300000,12300000,9800000,True
4820,21,1963-05-29,hud,2500000,10000000,10000000,7500000,True
4821,22,2013-08-02,the spectacular now,2500000,6852971,6916951,4416951,True
4822,23,1991-09-29,my own private idaho,2500000,6401336,6401336,3901336,True
4823,24,1995-01-27,before sunrise,2500000,5274005,5690220,3190220,True
4824,25,2016-06-24,hunt for the wilderpeople,2500000,5205471,23845533,21345533,True
4825,26,2012-08-17,robot & frank,2500000,3317468,4934356,2434356,True
4826,27,2003-10-03,sur le seuil,2500000,2013052,2013052,-486948,False
4827,28,2000-06-16,jesus' son,2500000,1282084,1687548,-812452,False
4828,29,2005-05-27,saving face,2500000,1187266,1269705,-1230295,False
4829,30,2008-06-20,brick lane,2500000,1094998,3838486,1338486,False
4830,31,2013-03-01,the lost medallion: the adventures of billy stone,2500000,549632,549632,-1950368,False
4831,32,2003-09-26,my life without me,2500000,432360,12267275,9767275,False
4832,33,2006-03-31,marilyn hotchkiss' ballroom dancing and charm school,2500000,349132,497195,-2002805,False
4833,34,2011-04-01,super,2500000,327716,593933,-1906067,False
4834,35,2008-11-14,fuel,2500000,174255,174255,-2325745,False
4835,36,2010-04-09,valley of the hearts delight,2500000,118666,118666,-2381334,False
4836,37,2008-10-31,the other end of the line,2500000,115504,507446,-1992554,False
4837,38,2010-06-18,8: the mormon proposition,2500000,100280,100280,-2399720,False
4838,39,2009-04-17,sleep dealer,2500000,80136,108907,-2391093,False
4839,40,2007-08-24,eye of the dolphin,2500000,72210,72260,-2427740,False
4840,41,2013-08-16,underdogs,2500000,35017,1392649,-1107351,False
4841,42,2000-09-08,anatomie,2500000,9598,9598,-2490402,False
4842,43,2009-12-31,the calling,2500000,0,0,-2500000,False
4843,44,2013-06-21,alien uprising,2500000,0,0,-2500000,False
4844,45,2010-12-31,christmas mail,2500000,0,0,-2500000,False
4845,46,2015-07-03,stung,2500000,0,0,-2500000,False
4846,47,2017-09-01,sky sharks,2500000,0,0,-2500000,False
4847,48,2015-10-13,8 days,2500000,0,0,-2500000,False
4848,49,2016-09-02,antibirth,2500000,0,0,-2500000,False
4849,50,2016-02-02,the rise of the krays,2500000,0,0,-2500000,False
4850,51,2014-12-31,not safe for work,2500000,0,0,-2500000,False
4851,52,2011-05-13,go for it!,2450000,180237,182358,-2267642,False
4852,53,1996-10-16,get on the bus,2400000,5691854,5691854,3291854,True
4853,54,2007-01-05,thr3e,2400000,1008849,1420418,-979582,False
4854,55,2006-09-01,idiocracy,2400000,444093,500296,-1899704,False
4855,56,2009-12-31,niktã©,2400000,0,1333891,-1066109,False
4856,57,2014-11-14,always woodstock,2400000,0,0,-2400000,False
4857,58,2007-07-25,this is england,2380000,327919,8739576,6359576,False
4858,59,1944-06-27,bathing beauty,2361000,3500000,3500000,1139000,True
4859,60,2015-03-20,do you believe?,2300000,12985600,14304931,12004931,True
4860,61,1951-07-17,show boat,2300000,11000000,11000000,8700000,True
4861,62,1998-05-01,"dancer, texas pop. 81",2300000,574838,574838,-1725162,False
4862,63,2014-09-05,frontera,2300000,59696,59696,-2240304,False
4863,64,2011-08-26,redemption road,2300000,29384,29384,-2270616,False
4864,65,2015-04-15,the toxic avenger part ii,2300000,0,0,-2300000,False
4865,66,2016-01-19,eden,2300000,0,0,-2300000,False
4866,67,1987-06-19,the brave little toaster,2300000,0,0,-2300000,False
4867,68,1940-02-09,pinocchio,2289247,84300000,84300000,82010753,True
4868,69,1940-11-13,fantasia,2280000,83320000,83320000,81040000,True
4869,70,1982-08-13,friday the 13th part 3,2250000,36690067,36690067,34440067,True
4870,71,1971-10-09,the french connection,2200000,41158757,41158757,38958757,True
4871,72,1985-03-22,friday the 13th part v: a new beginning,2200000,21930418,21930418,19730418,True
4872,73,2007-02-09,the last sin eater,2200000,388390,388390,-1811610,False
4873,74,2008-12-31,impact point,2200000,0,0,-2200000,False
4874,75,1945-05-03,the valley of decision,2160000,9132000,9132000,6972000,True
4875,76,2005-12-31,chicken tikka masala,2160000,0,37865,-2122135,False
4876,77,2008-10-07,jack brooks: monster slayer,2150000,0,0,-2150000,False
4877,78,1946-11-21,the best years of our lives,2100000,23600000,23600000,21500000,True
4878,79,2001-07-13,bully,2100000,881824,1381824,-718176,False
4879,80,2002-05-29,elling,2100000,313436,313436,-1786564,False
4880,81,2016-10-16,mi america,2100000,3330,3330,-2096670,False
4881,82,2009-07-14,[rec],2100000,0,23266821,21166821,False
4882,83,2012-12-31,infected,2100000,0,0,-2100000,False
4883,84,2010-12-31,lies in plain sight,2100000,0,0,-2100000,False
4884,85,2015-10-06,the timber,2100000,0,0,-2100000,False
4885,86,2016-01-19,sharkskin,2100000,0,0,-2100000,False
4886,87,2011-09-30,courageous,2000000,34522221,35185884,33185884,True
4887,88,1964-04-08,from russia with love,2000000,24800000,78900000,76900000,True
4888,89,1982-05-21,mad max 2: the road warrior,2000000,24600832,24600832,22600832,True
4889,90,1946-08-15,notorious,2000000,24464742,24464742,22464742,True
4890,91,1967-08-02,in the heat of the night,2000000,24379978,24407647,22407647,True
4891,92,1973-12-17,sleeper,2000000,18344729,18344729,16344729,True
4892,93,1972-08-11,everything you always wanted to know,2000000,18016290,18016290,16016290,True
4893,94,2015-03-13,it follows,2000000,14674077,23250755,21250755,True
4894,95,2018-07-13,eighth grade,2000000,13539710,14341016,12341016,True
4895,96,1962-12-25,to kill a mockingbird,2000000,13129846,13129846,11129846,True
4896,97,2012-03-09,silent house,2000000,12739737,16610760,14610760,True
4897,98,1999-10-08,boys don't cry,2000000,11540607,20741000,18741000,True
4898,99,2007-02-09,das leben der anderen,2000000,11284657,81197047,79197047,True
4899,100,2016-04-08,hardcore henry,2000000,9252038,17187434,15187434,True
4900,1,1962-06-13,lolita,2000000,9250000,9250000,7250000,True
4901,2,1940-08-30,boom town,2000000,9172000,9172000,7172000,True
4902,3,1947-11-11,gentleman's agreement,2000000,7800000,7800000,5800000,True
4903,4,1961-09-25,the hustler,2000000,7600000,7600000,5600000,True
4904,5,1986-12-31,witchboard,2000000,7369373,7369373,5369373,True
4905,6,2003-11-26,les triplettes de belleville,2000000,7301288,17403168,15403168,True
4906,7,1998-06-26,smoke signals,2000000,6719300,7756617,5756617,True
4907,8,2010-06-11,winter's bone,2000000,6531503,16131551,14131551,True
4908,9,2014-10-10,meet the mormons,2000000,6047363,6049171,4049171,True
4909,10,2003-08-15,american splendor,2000000,6003587,8685632,6685632,True
4910,11,2017-10-06,the florida project,2000000,5904366,11295324,9295324,True
4911,12,2017-08-25,all saints,2000000,5802208,5941994,3941994,True
4912,13,2004-07-02,before sunset,2000000,5792822,11217346,9217346,True
4913,14,2001-03-30,amores perros,2000000,5383834,20883834,18883834,True
4914,15,2003-08-20,thirteen,2000000,4601043,9505996,7505996,True
4915,16,2004-01-23,touching the void,2000000,4593598,15396525,13396525,True
4916,17,2010-10-08,inside job,2000000,4311834,7799257,5799257,True
4917,18,1938-05-24,alexander's ragtime band,2000000,4000000,4000000,2000000,True
4918,19,2005-06-17,me and you and everyone we know,2000000,3885134,9615464,7615464,True
4919,20,2015-08-28,we are your friends,2000000,3591417,10153415,8153415,True
4920,21,2006-11-10,harsh times,2000000,3337931,6225304,4225304,True
4921,22,2000-03-03,ghost dog: the way of the samurai,2000000,3330230,10672492,8672492,True
4922,23,2015-09-18,captive,2000000,2583301,2791973,791973,True
4923,24,2002-08-02,full frontal,2000000,2512846,3438804,1438804,True
4924,25,2018-06-08,hearts beat loud,2000000,2386254,2420962,420962,True
4925,26,2017-01-20,the resurrection of gavin stone,2000000,2303792,2303792,303792,True
4926,27,2008-12-25,waltz with bashir,2000000,2283849,13912289,11912289,True
4927,28,2006-06-28,strangers with candy,2000000,2072645,2077844,77844,True
4928,29,1992-03-01,night on earth,2000000,2015000,2022893,22893,True
4929,30,1993-01-29,nemesis,2000000,2001124,2001124,1124,True
4930,31,2006-10-04,shortbus,2000000,1985292,1985292,-14708,False
4931,32,2008-05-02,son of rambow: a home movie,2000000,1785505,11263263,9263263,False
4932,33,2003-09-12,"the book of mormon movie, volume 1: the journey",2000000,1660865,1660865,-339135,False
4933,34,2000-05-12,hamlet,2000000,1577287,2419669,419669,False
4934,35,2015-08-07,the diary of a teenage girl,2000000,1477002,2279959,279959,False
4935,36,2007-07-27,no end in sight,2000000,1433319,1433319,-566681,False
4936,37,2014-04-25,locke,2000000,1370646,2088390,88390,False
4937,38,1999-04-30,get real,2000000,1152411,1152411,-847589,False
4938,39,2007-09-07,in the shadow of the moon,2000000,1134358,2175587,175587,False
4939,40,2011-04-08,meek's cutoff,2000000,977772,1869928,-130072,False
4940,41,2014-11-28,the babadook,2000000,950792,7482387,5482387,False
4941,42,2005-02-11,inside deep throat,2000000,691880,691880,-1308120,False
4942,43,2001-09-28,dinner rush,2000000,638227,1075504,-924496,False
4943,44,2010-09-24,the virginity hit,2000000,636706,636706,-1363294,False
4944,45,1998-05-15,clockwatchers,2000000,537948,539961,-1460039,False
4945,46,1985-11-06,subway,2000000,390659,1663296,-336704,False
4946,47,2005-04-15,house of d,2000000,388532,466106,-1533894,False
4947,48,2008-01-18,teeth,2000000,347578,2350641,350641,False
4948,49,1996-07-26,stonewall,2000000,304602,304602,-1695398,False
4949,50,2006-09-08,sherrybaby,2000000,199176,759504,-1240496,False
4950,51,2015-02-13,the last five years,2000000,147299,205298,-1794702,False
4951,52,1998-09-18,six-string samurai,2000000,134624,134624,-1865376,False
4952,53,2000-05-26,hum to mohabbt karega,2000000,121807,121807,-1878193,False
4953,54,2005-04-15,it's all gone pete tong,2000000,120620,2226603,226603,False
4954,55,2010-01-29,saint john of las vegas,2000000,102645,102645,-1897355,False
4955,56,1998-04-15,24 7: twenty four seven,2000000,72544,72544,-1927456,False
4956,57,2014-09-19,pump,2000000,72277,72277,-1927723,False
4957,58,2008-10-24,roadside romeo,2000000,55202,2046090,46090,False
4958,59,2001-05-04,eureka,2000000,49388,76654,-1923346,False
4959,60,2015-04-07,lost river,2000000,45431,2009644,9644,False
4960,61,2003-07-18,this thing of ours,2000000,37227,37227,-1962773,False
4961,62,2015-10-09,knock knock,2000000,36336,6328516,4328516,False
4962,63,2017-02-03,growing up smith,2000000,35312,35312,-1964688,False
4963,64,2009-03-20,super capers,2000000,30955,30955,-1969045,False
4964,65,1993-01-01,return of the living dead 3,2000000,21000,21000,-1979000,False
4965,66,2009-11-20,the missing person,2000000,17896,17896,-1982104,False
4966,67,2012-10-19,the first time,2000000,17061,17061,-1982939,False
4967,68,2006-02-10,london,2000000,12667,12667,-1987333,False
4968,69,2010-08-27,circle,2000000,10024,10024,-1989976,False
4969,70,2008-10-31,eden lake,2000000,7321,4294373,2294373,False
4970,71,2010-06-11,jerusalema,2000000,7294,10679,-1989321,False
4971,72,2006-06-23,say uncle,2000000,5361,5361,-1994639,False
4972,73,2013-09-13,plush,2000000,3080,28864,-1971136,False
4973,74,2012-10-26,the ghastly love of johnny x,2000000,2436,2436,-1997564,False
4974,75,2009-12-29,lesbian vampire killers,2000000,0,3620902,1620902,False
4975,76,2011-09-09,grave encounters,2000000,0,2151887,151887,False
4976,77,2015-10-23,bone tomahawk,2000000,0,475846,-1524154,False
4977,78,2004-12-10,freeze frame,2000000,0,105377,-1894623,False
4978,79,2013-04-01,stitches,2000000,0,63555,-1936445,False
4979,80,2015-12-31,"to be frank, sinatra at 100",2000000,0,926,-1999074,False
4980,81,1971-04-28,bananas,2000000,0,0,-2000000,False
4981,82,2009-12-31,nine dead,2000000,0,0,-2000000,False
4982,83,2008-10-14,no man's land: the rise of reeker,2000000,0,0,-2000000,False
4983,84,2007-07-07,rockaway,2000000,0,0,-2000000,False
4984,85,1927-08-12,wings,2000000,0,0,-2000000,False
4985,86,2015-03-17,the lady from shanghai,2000000,0,0,-2000000,False
4986,87,2013-03-19,straight a's,2000000,0,0,-2000000,False
4987,88,2012-03-30,the legend of hellâs gate: an american conspiracy,2000000,0,0,-2000000,False
4988,89,2012-12-31,highway,2000000,0,0,-2000000,False
4989,90,2013-02-08,small apartments,2000000,0,0,-2000000,False
4990,91,2013-07-09,coffee town,2000000,0,0,-2000000,False
4991,92,2014-12-31,lucky dog,2000000,0,0,-2000000,False
4992,93,2001-12-31,pendulum,2000000,0,0,-2000000,False
4993,94,1966-10-16,a funny thing happened on the way to the forum,2000000,0,0,-2000000,False
4994,95,2008-09-23,slacker uprising,2000000,0,0,-2000000,False
4995,96,2015-03-20,the walking deceased,2000000,0,0,-2000000,False
4996,97,2011-12-31,true bromance,2000000,0,0,-2000000,False
4997,98,2015-08-21,the curse of downers grove,2000000,0,0,-2000000,False
4998,99,2015-12-31,wind walkers,2000000,0,0,-2000000,False
4999,100,2016-07-08,the dog lover,2000000,0,0,-2000000,False
5000,1,2015-12-01,shark lake,2000000,0,0,-2000000,False
5001,2,2010-09-24,buried,1987650,1044143,21270290,19282640,False
5002,3,2015-04-21,the marine 4,1950000,0,0,-1950000,False
5003,4,1987-05-08,river's edge,1900000,4600000,4600000,2700000,True
5004,5,2008-07-25,man on wire,1900000,2962242,5617067,3717067,True
5005,6,2010-10-08,nowhere boy,1900000,1445366,7785229,5885229,False
5006,7,2003-07-11,northfork,1900000,1420578,1445140,-454860,False
5007,8,2015-04-24,brotherly love,1900000,478595,478595,-1421405,False
5008,9,2011-06-03,submarine,1900000,467602,4581937,2681937,False
5009,10,2010-04-09,the square,1900000,406216,740932,-1159068,False
5010,11,2013-02-08,abcd (any body can dance),1900000,222098,10137234,8237234,False
5011,12,2007-06-29,chacun sa nuit,1900000,18435,139317,-1760683,False
5012,13,2013-07-26,stranded,1900000,0,285593,-1614407,False
5013,14,2015-12-31,vaalu,1900000,0,12444,-1887556,False
5014,15,2010-08-27,the last exorcism,1800000,41034350,70165900,68365900,True
5015,16,1976-11-16,carrie,1800000,25878153,25878153,24078153,True
5016,17,1984-11-09,a nightmare on elm street,1800000,25504513,25504513,23704513,True
5017,18,2012-06-27,beasts of the southern wild,1800000,12795746,23265132,21465132,True
5018,19,1964-01-29,dr. strangelove,1800000,9164370,9230678,7430678,True
5019,20,1973-01-01,battle for the planet of the apes,1800000,8800000,8800000,7000000,True
5020,21,1951-09-18,a streetcar named desire,1800000,8000000,8000000,6200000,True
5021,22,1968-08-03,hang 'em high,1800000,6800000,6800000,5000000,True
5022,23,2002-11-15,el crimen de padre amaro,1800000,5719000,5719000,3919000,True
5023,24,2001-06-15,songcatcher,1800000,3050934,3050934,1250934,True
5024,25,2011-08-23,higher ground,1800000,841056,842693,-957307,False
5025,26,2011-04-22,pom wonderful presents: the greatest movie ever sold,1800000,638476,783733,-1016267,False
5026,27,2005-01-07,travellers and magicians,1800000,506793,1322161,-477839,False
5027,28,1993-01-01,ed and his dead mother,1800000,673,673,-1799327,False
5028,29,2009-12-31,deadline,1800000,0,0,-1800000,False
5029,30,2007-03-13,sublime,1800000,0,0,-1800000,False
5030,31,2012-02-03,dysfunctional friends,1800000,0,0,-1800000,False
5031,32,2013-12-31,independence daysaster,1800000,0,0,-1800000,False
5032,33,2014-03-11,against the wild,1800000,0,0,-1800000,False
5033,34,2015-10-20,beginnerâs guide to sex,1800000,0,0,-1800000,False
5034,35,1999-06-18,lola rennt,1750000,7267324,22879194,21129194,True
5035,36,2003-02-07,may,1750000,145540,634803,-1115197,False
5036,37,2010-10-08,i spit on your grave,1750000,93051,1278471,-471529,False
5037,38,2019-04-23,living dark: the story of ted the caver,1750000,0,0,-1750000,False
5038,39,2001-11-23,in the bedroom,1700000,35930604,42137871,40437871,True
5039,40,2008-03-19,la misma luna,1700000,12590147,23271741,21571741,True
5040,41,1972-06-30,conquest of the planet of the apes,1700000,9700000,9700000,8000000,True
5041,42,2014-02-28,the lunchbox,1700000,4231500,12231500,10531500,True
5042,43,2013-10-04,grace unplugged,1700000,2507159,2507159,807159,True
5043,44,1999-10-01,"happy, texas",1700000,2039192,2891228,1191228,True
5044,45,2015-12-18,saul fia,1700000,1777043,9696537,7996537,True
5045,46,2005-06-17,my summer of love,1700000,1000915,4727375,3027375,False
5046,47,2005-06-24,yes,1700000,396035,661221,-1038779,False
5047,48,2019-02-01,braid,1660000,0,80745,-1579255,False
5048,49,1953-08-05,from here to eternity,1650000,30500000,30500000,28850000,True
5049,50,1938-09-01,you can't take it with you,1644000,4000000,4000000,2356000,True
5050,51,1999-04-09,foolish,1600000,6026908,6026908,4426908,True
5051,52,1949-07-26,she wore a yellow ribbon,1600000,5400000,5400000,3800000,True
5052,53,1974-04-07,the conversation,1600000,4420000,4420000,2820000,True
5053,54,2010-10-15,n-secure,1600000,2595644,2595644,995644,True
5054,55,2008-02-01,sukkar banat,1600000,1060591,14253760,12653760,False
5055,56,1989-12-31,out of the dark,1600000,419428,419428,-1180572,False
5056,57,2006-01-27,bubble,1600000,145382,145382,-1454618,False
5057,58,2005-09-23,dil jo bhi kahey...,1600000,129319,129319,-1470681,False
5058,59,1999-01-15,mississippi mermaid,1600000,27795,2627795,1027795,False
5059,60,2014-09-26,two night stand,1600000,15600,868081,-731919,False
5060,61,2005-11-04,i love your work,1600000,3264,3264,-1596736,False
5061,62,1955-08-05,the kingâs thief,1577000,0,0,-1577000,False
5062,63,2011-04-01,insidious,1500000,54009150,99870886,98370886,True
5063,64,2016-10-21,moonlight,1500000,27854931,65245512,63745512,True
5064,65,2003-09-12,cabin fever,1500000,21158188,30351664,28851664,True
5065,66,2007-05-02,waitress,1500000,19097550,22217183,20717183,True
5066,67,1989-09-08,kickboxer,1500000,14533681,14533681,13033681,True
5067,68,1988-02-26,bloodsport,1500000,11806119,11806119,10306119,True
5068,69,1939-10-17,mr. smith goes to washington,1500000,9000000,9000000,7500000,True
5069,70,2018-03-23,unsane,1500000,7690044,14244931,12744931,True
5070,71,1995-07-21,kids,1500000,7412216,20412216,18912216,True
5071,72,2005-10-05,the squid and the whale,1500000,7372734,11191423,9691423,True
5072,73,2002-03-13,kissing jessica stein,1500000,7025722,9345061,7845061,True
5073,74,1945-10-31,spellbound,1500000,7000000,7000000,5500000,True
5074,75,1979-04-20,dawn of the dead,1500000,5100000,55000000,53500000,True
5075,76,1994-09-23,exotica,1500000,5046118,5046118,3546118,True
5076,77,2013-07-26,the to do list,1500000,3491669,4128828,2628828,True
5077,78,2013-02-01,the gatekeepers,1500000,2408553,2592308,1092308,True
5078,79,1998-06-26,buffalo '66,1500000,2380606,2380606,880606,True
5079,80,1984-03-02,repo man,1500000,2300000,2300000,800000,True
5080,81,2016-10-21,iâm not ashamed,1500000,2082980,2082980,582980,True
5081,82,1985-01-18,blood simple,1500000,1690913,2730877,1230877,True
5082,83,2002-04-19,nueve reinas,1500000,1222889,12412889,10912889,False
5083,84,2013-04-19,the lords of salem,1500000,1165881,1541131,41131,False
5084,85,2016-10-21,31,1500000,779820,922727,-577273,False
5085,86,2005-03-25,the ballad of jack and rose,1500000,712294,1126258,-373742,False
5086,87,2016-04-22,unsullied,1500000,510957,510957,-989043,False
5087,88,1994-08-31,killing zoe,1500000,418953,418953,-1081047,False
5088,89,2002-05-17,the believer,1500000,406035,1840248,340248,False
5089,90,2008-03-07,snow angels,1500000,402858,414404,-1085596,False
5090,91,2001-08-10,session 9,1500000,378176,1619602,119602,False
5091,92,2011-02-11,mooz-lum,1500000,362239,372239,-1127761,False
5092,93,2007-09-05,i want someone to eat cheese with,1500000,194568,194568,-1305432,False
5093,94,2011-08-19,amigo,1500000,184705,184705,-1315295,False
5094,95,2007-09-07,hatchet,1500000,175281,240396,-1259604,False
5095,96,2008-10-31,my name is bruce,1500000,173066,173066,-1326934,False
5096,97,2010-08-06,the disappearance of alice creed,1500000,166980,1605139,105139,False
5097,98,1936-02-05,modern times,1500000,163245,199747,-1300253,False
5098,99,2007-05-11,the salon,1500000,139084,139084,-1360916,False
5099,100,2013-10-25,the square,1500000,124244,176262,-1323738,False
5100,1,2002-03-22,stolen summer,1500000,119841,119841,-1380159,False
5101,2,2015-03-06,road hard,1500000,113169,113169,-1386831,False
5102,3,2005-09-28,forty shades of blue,1500000,75828,172569,-1327431,False
5103,4,2009-10-09,trucker,1500000,52429,52429,-1447571,False
5104,5,2009-05-29,pontypool,1500000,3865,31916,-1468084,False
5105,6,2015-09-28,"me, you and five bucks",1500000,2105,2105,-1497895,False
5106,7,2014-10-17,housebound,1500000,0,236863,-1263137,False
5107,8,2018-07-20,teefa in trouble,1500000,0,98806,-1401194,False
5108,9,2005-11-04,wal-mart: the high cost of low price,1500000,0,58692,-1441308,False
5109,10,2014-04-17,closer to the moon,1500000,0,5396,-1494604,False
5110,11,2006-03-17,fetching cody,1500000,0,0,-1500000,False
5111,12,2011-06-03,the lion of judah,1500000,0,0,-1500000,False
5112,13,2014-11-11,once upon a time in queens,1500000,0,0,-1500000,False
5113,14,2015-02-13,girlhouse,1500000,0,0,-1500000,False
5114,15,2015-05-26,mutant world,1500000,0,0,-1500000,False
5115,16,2015-11-20,#horror,1500000,0,0,-1500000,False
5116,17,2015-09-08,checkmate,1500000,0,0,-1500000,False
5117,18,1937-12-21,snow white and the seven dwarfs,1488000,184925486,184925486,183437486,True
5118,19,1968-01-01,shalako,1455000,2620000,2620000,1165000,True
5119,20,2018-11-30,werk ohne autor,1400000,1303747,4331152,2931152,False
5120,21,2015-11-20,mustang,1400000,845464,5552584,4152584,False
5121,22,2005-04-29,the holy girl,1400000,304124,1261792,-138208,False
5122,23,2014-10-03,la chambre bleue,1400000,260441,1945420,545420,False
5123,24,2004-09-17,incident at loch ness,1400000,36830,56073,-1343927,False
5124,25,2013-04-05,eddie: the sleepwalking cannibal,1400000,1632,1632,-1398368,False
5125,26,2010-05-01,my girlfriend's boyfriend,1400000,0,0,-1400000,False
5126,27,2014-12-31,kurmanjan datka,1400000,0,0,-1400000,False
5127,28,2014-12-31,house at the end of the drive,1400000,0,0,-1400000,False
5128,29,1966-07-06,batman - the movie,1377800,0,0,-1377800,False
5129,30,1999-03-05,"lock, stock and two smoking barrels",1350000,3897569,28356188,27006188,True
5130,31,1983-08-19,the ballad of gregorio cortez,1305000,909000,909000,-396000,False
5131,32,1936-06-26,san francisco,1300000,2868000,5273000,3973000,True
5132,33,1998-10-09,festen,1300000,1647780,1647780,347780,True
5133,34,1996-10-11,trees lounge,1300000,749741,749741,-550259,False
5134,35,2009-05-22,the girlfriend experience,1300000,695840,1005840,-294160,False
5135,36,2007-03-23,journey from the fall,1300000,635305,635305,-664695,False
5136,37,2000-05-05,the basket,1300000,609042,609042,-690958,False
5137,38,2015-01-30,above and beyond,1300000,288751,288751,-1011249,False
5138,39,1985-03-15,def-con 4,1300000,210904,210904,-1089096,False
5139,40,2005-12-09,neal n' nikki,1300000,100358,329621,-970379,False
5140,41,2003-12-19,the hebrew hammer,1300000,77755,90213,-1209787,False
5141,42,2014-06-13,los insolitos peces gato,1300000,11278,54665,-1245335,False
5142,43,2006-04-07,simon,1300000,4055,1738663,438663,False
5143,44,2011-05-24,forget me not,1300000,0,13465,-1286535,False
5144,45,2010-06-08,the 41-year-old virgin who knocked up sarah marshall and felt superbad about it,1300000,0,0,-1300000,False
5145,46,2015-06-26,the algerian,1300000,0,0,-1300000,False
5146,47,1940-03-21,rebecca,1288000,6000000,6002370,4714370,True
5147,48,1981-04-30,friday the 13th part 2,1250000,21722776,21722776,20472776,True
5148,49,1945-11-29,the lost weekend,1250000,11000000,11000000,9750000,True
5149,50,1984-08-31,c.h.u.d.,1250000,4700000,4700000,3450000,True
5150,51,2014-10-17,dear white people,1250000,4404154,5403771,4153771,True
5151,52,2013-04-19,filly brown,1250000,2850357,2940411,1690411,True
5152,53,1953-01-21,niagara,1250000,2500000,2500000,1250000,True
5153,54,2016-12-31,bodom,1250000,0,726460,-523540,False
5154,55,1941-10-28,how green was my valley,1250000,0,0,-1250000,False
5155,56,2015-01-13,da sweet blood of jesus,1250000,0,0,-1250000,False
5156,57,2004-10-29,saw,1200000,55968727,103880027,102680027,True
5157,58,1989-08-04,"sex, lies, and videotape",1200000,24741667,36741667,35541667,True
5158,59,2002-02-15,super troopers,1200000,18492362,23046142,21846142,True
5159,60,2002-02-22,monsoon wedding,1200000,13876974,27025600,25825600,True
5160,61,2000-11-10,you can count on me,1200000,9180275,10827356,9627356,True
5161,62,1951-07-03,strangers on a train,1200000,7000000,7000000,5800000,True
5162,63,1955-10-03,the trouble with harry,1200000,7000000,7000000,5800000,True
5163,64,1967-12-29,"il buono, il brutto, il cattivo",1200000,6100000,6100000,4900000,True
5164,65,1951-09-18,the day the earth stood still,1200000,3700000,3700000,2500000,True
5165,66,2013-04-19,home run,1200000,2859955,2859955,1659955,True
5166,67,1992-10-23,reservoir dogs,1200000,2832029,2832029,1632029,True
5167,68,2000-07-07,but i'm a cheerleader,1200000,2205627,2509344,1309344,True
5168,69,1956-12-23,the wrong man,1200000,2000000,2000000,800000,True
5169,70,1975-09-26,the rocky horror picture show,1200000,1414845,1615976,415976,True
5170,71,1976-01-01,the blue bird,1200000,887000,887000,-313000,False
5171,72,2012-04-13,blue like jazz,1200000,595018,595018,-604982,False
5172,73,2015-08-28,que horas ela volta?,1200000,376976,3249041,2049041,False
5173,74,1982-11-19,q,1200000,255000,255000,-945000,False
5174,75,2003-03-21,down & out with the dolls,1200000,58936,58936,-1141064,False
5175,76,2012-06-01,"pink ribbons, inc.",1200000,26608,26608,-1173392,False
5176,77,2018-02-06,blood feast,1200000,8708,8708,-1191292,False
5177,78,2011-02-11,certifiably jonathan,1200000,7826,7826,-1192174,False
5178,79,2015-09-18,la navaja de don juan,1200000,4254,4254,-1195746,False
5179,80,2008-12-31,extreme movie,1200000,0,81338,-1118662,False
5180,81,1936-10-20,the charge of the light brigade,1200000,0,0,-1200000,False
5181,82,2004-06-18,grand theft parsons,1200000,0,0,-1200000,False
5182,83,2012-08-28,below zero,1200000,0,0,-1200000,False
5183,84,2012-09-07,crowsnest,1200000,0,0,-1200000,False
5184,85,2012-09-14,airborne,1200000,0,0,-1200000,False
5185,86,2014-09-09,cotton comes to harlem,1200000,0,0,-1200000,False
5186,87,2015-02-03,bleeding hearts,1200000,0,0,-1200000,False
5187,88,2013-12-31,the wicked within,1200000,0,0,-1200000,False
5188,89,2017-12-31,the islands,1200000,0,0,-1200000,False
5189,90,2014-03-21,godâs not dead,1150000,60755732,63777092,62627092,True
5190,91,2005-10-07,waiting...,1125000,16124543,18673274,17548274,True
5191,92,2006-05-12,dead man's shoes,1125000,6408,414736,-710264,False
5192,93,1980-02-01,the fog,1100000,21445318,21445820,20345820,True
5193,94,2005-12-25,wolf creek,1100000,16186348,29005064,27905064,True
5194,95,2005-02-11,ong-bak,1100000,4563167,24062965,22962965,True
5195,96,2012-03-23,serbuan maut,1100000,4105123,9297407,8197407,True
5196,97,1986-09-26,down by law,1100000,1436000,1436000,336000,True
5197,98,1987-09-04,the offspring,1100000,1355728,1355728,255728,True
5198,99,2002-02-22,sex with strangers,1100000,247740,247740,-852260,False
5199,100,2012-05-18,beyond the black rainbow,1100000,56491,56491,-1043509,False
5200,1,2003-05-14,dracula: pages from a virgin's diary,1100000,39659,81371,-1018629,False
5201,2,2014-11-21,the sleepwalker,1100000,2636,2636,-1097364,False
5202,3,2017-03-07,departure,1100000,0,27561,-1072439,False
5203,4,2009-04-07,faith like potatoes,1100000,0,0,-1100000,False
5204,5,2010-03-23,lake mungo,1100000,0,0,-1100000,False
5205,6,2015-04-07,silent running,1100000,0,0,-1100000,False
5206,7,2010-12-31,the dead undead,1100000,0,0,-1100000,False
5207,8,2013-12-31,the vatican exorcisms,1100000,0,0,-1100000,False
5208,9,2009-12-11,rocket singh: salesman of the year,1070000,164649,5348767,4278767,False
5209,10,1943-01-23,casablanca,1039000,10462500,10496855,9457855,True
5210,11,1976-11-21,rocky,1000000,117235147,225000000,224000000,True
5211,12,2012-01-06,the devil inside,1000000,53262945,101759490,100759490,True
5212,13,1963-10-07,tom jones,1000000,37600000,37600000,36600000,True
5213,14,2015-04-17,unfriended,1000000,32789645,64364198,63364198,True
5214,15,1976-02-08,taxi driver,1000000,28262574,28316211,27316211,True
5215,16,2006-05-24,an inconvenient truth,1000000,24146161,53365925,52365925,True
5216,17,2013-08-23,you're next,1000000,18494006,26887177,25887177,True
5217,18,2012-05-25,chernobyl diaries,1000000,18119640,42411721,41411721,True
5218,19,1981-04-10,the howling,1000000,17985000,17985000,16985000,True
5219,20,1963-05-08,dr. no,1000000,16067035,59567035,58567035,True
5220,21,1987-09-18,hellraiser,1000000,14564000,14575148,13575148,True
5221,22,2016-03-11,"hello, my name is doris",1000000,14444999,14662703,13662703,True
5222,23,2005-09-16,cry wolf,1000000,10047674,15943081,14943081,True
5223,24,2000-08-18,godzilla 2000,1000000,10037390,10037390,9037390,True
5224,25,2010-12-29,blue valentine,1000000,9737892,16566240,15566240,True
5225,26,2006-01-20,transamerica,1000000,9015303,16553163,15553163,True
5226,27,1970-01-01,beyond the valley of the dolls,1000000,9000000,9000000,8000000,True
5227,28,1956-11-15,love me tender,1000000,9000000,9000000,8000000,True
5228,29,2018-07-20,unfriended: dark web,1000000,8866745,16434588,15434588,True
5229,30,1949-12-14,sands of iwo jima,1000000,7800000,7800000,6800000,True
5230,31,2015-09-25,the green inferno,1000000,7192291,12931420,11931420,True
5231,32,2017-02-03,i am not your negro,1000000,7123919,9617402,8617402,True
5232,33,2012-10-19,the sessions,1000000,6002451,11495204,10495204,True
5233,34,2008-04-04,shine a light,1000000,5505267,16173879,15173879,True
5234,35,2012-03-23,october baby,1000000,5355847,5391992,4391992,True
5235,36,2014-09-12,the skeleton twins,1000000,5284309,5797192,4797192,True
5236,37,2013-06-14,20 feet from stardom,1000000,4946250,5892466,4892466,True
5237,38,2009-06-12,"food, inc.",1000000,4417674,4731944,3731944,True
5238,39,2017-07-28,an inconvenient sequel,1000000,3496795,5839322,4839322,True
5239,40,1998-08-21,next stop wonderland,1000000,3395581,3465703,2465703,True
5240,41,2014-06-06,obvious child,1000000,3122616,3324070,2324070,True
5241,42,2011-10-21,martha marcy may marlene,1000000,2981038,5438911,4438911,True
5242,43,2005-08-03,junebug,1000000,2678010,3553253,2553253,True
5243,44,2008-08-01,frozen river,1000000,2511476,6030129,5030129,True
5244,45,2001-11-21,sidewalks of new york,1000000,2402459,3575308,2575308,True
5245,46,1998-04-24,two girls and a guy,1000000,2057193,2315026,1315026,True
5246,47,2000-09-29,the broken hearts club: a romantic comedy,1000000,1744858,2022442,1022442,True
5247,48,2006-06-28,who killed the electric car?,1000000,1678874,1849392,849392,True
5248,49,2009-09-18,the secrets of jonathan sperry,1000000,1355079,1355079,355079,True
5249,50,1996-07-17,walking and talking,1000000,1287480,1615787,615787,True
5250,51,2003-09-19,bubba ho-tep,1000000,1239183,1492895,492895,True
5251,52,2001-12-07,no man's land,1000000,1067481,2684207,1684207,True
5252,53,1998-10-09,slam,1000000,1009819,1087521,87521,True
5253,54,2017-10-06,visages villages,1000000,952432,4015686,3015686,False
5254,55,2001-04-06,brigham city,1000000,852206,852206,-147794,False
5255,56,2017-08-18,patti cake$,1000000,800148,1471090,471090,False
5256,57,2000-12-01,panic,1000000,779137,1425707,425707,False
5257,58,2014-05-09,palo alto,1000000,767732,1156309,156309,False
5258,59,2000-09-08,fiza,1000000,623791,1179462,179462,False
5259,60,2010-02-03,ajami,1000000,621859,2721096,1721096,False
5260,61,1998-10-23,orgazmo,1000000,582024,627287,-372713,False
5261,62,2011-07-29,the future,1000000,568662,1239174,239174,False
5262,63,2003-02-14,all the real girls,1000000,549666,703020,-296980,False
5263,64,2014-10-24,23 blast,1000000,549185,549185,-450815,False
5264,65,1997-06-20,dream with the fishes,1000000,542909,542909,-457091,False
5265,66,2013-07-19,the act of killing,1000000,486919,1227316,227316,False
5266,67,2003-05-02,blue car,1000000,464126,475367,-524633,False
5267,68,2007-10-19,wristcutters: a love story,1000000,446165,473769,-526231,False
5268,69,2000-05-05,luminarias,1000000,428535,428535,-571465,False
5269,70,2014-07-18,i origins,1000000,336472,852399,-147601,False
5270,71,2014-11-28,antarctica: a year on ice,1000000,288757,288757,-711243,False
5271,72,2003-08-22,the battle of shaker heights,1000000,280351,839145,-160855,False
5272,73,2008-01-18,taxi to the dark side,1000000,274661,304472,-695528,False
5273,74,2016-04-08,the invitation,1000000,231738,354836,-645164,False
5274,75,2004-09-24,guiana 1838,1000000,227241,227241,-772759,False
5275,76,2002-12-30,love liza,1000000,213137,213137,-786863,False
5276,77,2006-07-07,once in a lifetime: the extraordinary story of the new york cosmos,1000000,144601,215559,-784441,False
5277,78,2001-08-22,lisa picard is famous,1000000,113433,113433,-886567,False
5278,79,2015-07-31,beyond the brick: a lego brickumentary,1000000,101531,101531,-898469,False
5279,80,2009-10-30,the house of the devil,1000000,101215,102812,-897188,False
5280,81,2012-06-01,hardflip,1000000,96734,96734,-903266,False
5281,82,2016-03-11,creative control,1000000,63014,63014,-936986,False
5282,83,2005-09-16,chocolate: deep dark secrets,1000000,49000,1549000,549000,False
5283,84,2011-07-01,the perfect host,1000000,48764,51587,-948413,False
5284,85,1998-09-25,the last big thing,1000000,22434,22434,-977566,False
5285,86,1998-08-07,safe men,1000000,21210,21210,-978790,False
5286,87,2001-08-31,speedway junky,1000000,17127,17127,-982873,False
5287,88,2015-02-13,hits,1000000,15156,15156,-984844,False
5288,89,2000-09-22,the specials,1000000,12996,12996,-987004,False
5289,90,2010-09-03,16 to life,1000000,11574,11574,-988426,False
5290,91,2007-01-17,alone with her,1000000,10787,844377,-155623,False
5291,92,2014-10-17,camp x-ray,1000000,9837,101053,-898947,False
5292,93,2008-11-21,special,1000000,7202,26822,-973178,False
5293,94,2015-04-10,the sisterhood of night,1000000,6870,6870,-993130,False
5294,95,1999-03-19,sparkler,1000000,5494,5494,-994506,False
5295,96,2005-03-18,the helixâ¦loaded,1000000,3700,3700,-996300,False
5296,97,2015-05-15,childless,1000000,1036,1036,-998964,False
5297,98,2006-04-21,in her line of fire,1000000,884,884,-999116,False
5298,99,2002-12-13,the jimmy show,1000000,703,703,-999297,False
5299,100,2013-12-31,heli,1000000,0,552614,-447386,False
5300,1,2015-12-31,karachi se lahore,1000000,0,17721,-982279,False
5301,2,2006-12-31,loving annabelle,1000000,0,5382,-994618,False
5302,3,2015-12-11,american hero,1000000,0,26,-999974,False
5303,4,2009-12-01,frat party,1000000,0,0,-1000000,False
5304,5,2006-09-15,jimmy and judy,1000000,0,0,-1000000,False
5305,6,2003-10-24,the party's over,1000000,0,0,-1000000,False
5306,7,2009-07-17,the poker house,1000000,0,0,-1000000,False
5307,8,2005-09-23,proud,1000000,0,0,-1000000,False
5308,9,2008-12-31,steppin: the movie,1000000,0,0,-1000000,False
5309,10,2010-01-29,zombies of mass destruction,1000000,0,0,-1000000,False
5310,11,2012-03-20,snow white: a deadly summer,1000000,0,0,-1000000,False
5311,12,2012-10-09,truth or die,1000000,0,0,-1000000,False
5312,13,2013-05-14,black rock,1000000,0,0,-1000000,False
5313,14,2014-01-07,hidden away,1000000,0,0,-1000000,False
5314,15,2013-10-04,my last day without you,1000000,0,0,-1000000,False
5315,16,2013-10-08,zombie hunter,1000000,0,0,-1000000,False
5316,17,2014-12-31,doc holliday's revenge,1000000,0,0,-1000000,False
5317,18,2014-06-24,a fine step,1000000,0,0,-1000000,False
5318,19,2015-02-10,fear clinic,1000000,0,0,-1000000,False
5319,20,2015-03-10,the pet,1000000,0,0,-1000000,False
5320,21,2014-12-31,bang bang baby,1000000,0,0,-1000000,False
5321,22,2016-04-08,hush,1000000,0,0,-1000000,False
5322,23,2016-03-01,1982,1000000,0,0,-1000000,False
5323,24,2015-10-27,the horror network,1000000,0,0,-1000000,False
5324,25,2016-12-31,chemical cut,1000000,0,0,-1000000,False
5325,26,2015-12-22,por amor en el caserio,1000000,0,0,-1000000,False
5326,27,2007-06-01,and then came love,989000,8158,8158,-980842,False
5327,28,2006-04-14,hard candy,950000,1024640,8267066,7317066,True
5328,29,2002-09-27,charly,950000,814666,814666,-135334,False
5329,30,2014-01-10,banshee chapter,950000,0,78122,-871878,False
5330,31,2012-12-31,trance,950000,0,0,-950000,False
5331,32,2014-08-12,jesse,950000,0,0,-950000,False
5332,33,2015-03-03,ask me anything,950000,0,0,-950000,False
5333,34,2012-04-13,l!fe happens,930000,30905,30905,-899095,False
5334,35,2017-05-12,lowriders,916000,6179955,6188421,5272421,True
5335,36,2014-11-21,food chains,913000,0,176,-912824,False
5336,37,1954-07-28,on the waterfront,910000,9600000,9600000,8690000,True
5337,38,2013-07-12,fruitvale station,900000,16098998,17549645,16649645,True
5338,39,2016-04-01,meet the blacks,900000,9097072,9097072,8197072,True
5339,40,2008-01-25,"4 luni, 3 saptamani si 2 zile",900000,1196321,11993156,11093156,True
5340,41,2011-08-26,circumstance,900000,454121,958978,58978,False
5341,42,2006-08-25,the quiet,900000,381420,381420,-518580,False
5342,43,2012-04-27,the giant mechanical man,900000,7396,7396,-892604,False
5343,44,2013-04-05,the brass teapot,900000,6997,413733,-486267,False
5344,45,2014-12-31,40 weeks,900000,0,0,-900000,False
5345,46,2015-05-05,le bonheur d'elza,900000,0,0,-900000,False
5346,47,1942-08-13,bambi,858000,102797000,268000000,267142000,True
5347,48,2012-08-31,"for a good time, call",850000,1251749,1386088,536088,True
5348,49,2004-01-30,latter days,850000,833118,865708,15708,False
5349,50,2008-03-21,the hammer,850000,442638,442638,-407362,False
5350,51,2015-08-28,windsor drive,850000,3256,3256,-846744,False
5351,52,2012-12-31,snitch,850000,0,0,-850000,False
5352,53,2008-12-31,harrison montgomery,850000,0,0,-850000,False
5353,54,2012-08-03,celeste and jesse forever,840000,3103407,3787689,2947689,True
5354,55,2002-10-25,time changer,825000,1500711,1500711,675711,True
5355,56,2009-08-11,london to brighton,825000,0,610776,-214224,False
5356,57,2009-12-31,crying with laughter,820000,0,16909,-803091,False
5357,58,1971-01-01,billy jack,800000,98000000,98000000,97200000,True
5358,59,2011-12-30,jodaeiye nader az simin,800000,7098492,24426169,23626169,True
5359,60,1996-05-10,welcome to the dollhouse,800000,4198137,5034794,4234794,True
5360,61,2003-03-28,raising victor vargas,800000,2073984,2900578,2100578,True
5361,62,1993-10-01,ruby in paradise,800000,1001437,1001437,201437,True
5362,63,2002-08-09,pandora's box,800000,881950,881950,81950,True
5363,64,2007-07-18,cama adentro,800000,200433,200433,-599567,False
5364,65,2000-03-10,deterrence,800000,144583,371647,-428353,False
5365,66,2004-05-07,the mudge boy,800000,62544,62544,-737456,False
5366,67,2003-04-11,the young unknowns,800000,58163,58163,-741837,False
5367,68,2009-06-19,dã¸d snã¸,800000,46742,2194020,1394020,False
5368,69,2014-09-19,not cool,800000,35688,35688,-764312,False
5369,70,2012-02-03,kill list,800000,29063,462206,-337794,False
5370,71,2015-01-09,vessel,800000,0,0,-800000,False
5371,72,2004-08-06,saints and soldiers,780000,1310470,1310470,530470,True
5372,73,1973-08-11,american graffiti,777000,115000000,140000000,139223000,True
5373,74,2006-09-08,iraq for sale: the war profiteers,775000,0,0,-775000,False
5374,75,2011-09-09,kevin hart: laugh at my pain,750000,7706436,7712436,6962436,True
5375,76,2007-04-13,aqua teen hunger force colon movie film for theaters,750000,5520368,5520368,4770368,True
5376,77,2012-06-08,safety not guaranteed,750000,4010957,4422318,3672318,True
5377,78,2012-02-03,the innkeepers,750000,78396,1011535,261535,False
5378,79,2014-08-29,il conformista,750000,59656,89609,-660391,False
5379,80,2002-11-15,interview with the assassin,750000,47329,47329,-702671,False
5380,81,2005-07-01,undead,750000,41196,229250,-520750,False
5381,82,2009-01-23,donkey punch,750000,19367,814801,64801,False
5382,83,2013-10-11,all the boys love mandy lane,750000,0,1960521,1210521,False
5383,84,2014-12-31,destiny,750000,0,450,-749550,False
5384,85,2009-04-07,bled,750000,0,0,-750000,False
5385,86,2016-01-05,adulterers,750000,0,0,-750000,False
5386,87,1968-06-25,la mariã©e ã©tait en noir,747000,44566,44566,-702434,False
5387,88,1952-07-24,high noon,730000,8000000,8000000,7270000,True
5388,89,1994-10-14,hoop dreams,700000,7768371,11768371,11068371,True
5389,90,2005-06-24,rize,700000,3278611,4857731,4157731,True
5390,91,2006-08-11,half nelson,700000,2697938,4911725,4211725,True
5391,92,2001-09-07,l.i.e.,700000,1140965,1140965,440965,True
5392,93,2017-08-04,columbus,700000,1017107,1110511,410511,True
5393,94,1999-10-08,naturally native,700000,10508,10508,-689492,False
5394,95,2010-01-26,b-girl,700000,0,1160,-698840,False
5395,96,2015-03-13,walter,700000,0,0,-700000,False
5396,97,1933-04-07,king kong,672000,10000000,10000650,9328650,True
5397,98,1953-04-10,house of wax,658000,23800000,23800000,23142000,True
5398,99,1998-06-19,hav plenty,650000,2301777,2301777,1651777,True
5399,100,2013-10-11,escape from tomorrow,650000,171962,171962,-478038,False
5400,1,2018-12-14,that way madness lies,650000,1447,1447,-648553,False
5401,2,2012-12-31,after,650000,0,0,-650000,False
5402,3,2014-12-31,the hadza: last of the first,650000,0,0,-650000,False
5403,4,2009-12-31,starsuckers,640000,0,14812,-625188,False
5404,5,2013-12-31,treachery,625000,0,0,-625000,False
5405,6,1935-09-06,top hat,609000,1782000,3202000,2593000,True
5406,7,1999-07-14,the blair witch project,600000,140539099,248300000,247700000,True
5407,8,1970-03-26,woodstock,600000,34505110,34505110,33905110,True
5408,9,1977-08-10,the kentucky fried movie,600000,15000000,20000000,19400000,True
5409,10,1967-05-10,per qualche dollaro in piã¹,600000,4300000,4300000,3700000,True
5410,11,2000-10-31,mercy streets,600000,173599,173599,-426401,False
5411,12,2014-05-02,water & power,600000,42557,42557,-557443,False
5412,13,2007-10-19,arnolds park,600000,23616,23616,-576384,False
5413,14,1999-07-02,broken vessels,600000,15030,85343,-514657,False
5414,15,2015-05-22,drunk wedding,600000,3301,3301,-596699,False
5415,16,2016-03-04,they will have to kill us first,600000,0,7943,-592057,False
5416,17,2002-08-23,crop circles: quest for truth,600000,0,0,-600000,False
5417,18,2014-08-08,the maid's room,600000,0,0,-600000,False
5418,19,2014-12-31,light from the darkroom,600000,0,0,-600000,False
5419,20,2015-02-24,irreplaceable,600000,0,0,-600000,False
5420,21,1964-08-11,a hard day's night,560000,1537860,1626784,1066784,True
5421,22,2011-07-29,the harvest/la cosecha,560000,3709,3709,-556291,False
5422,23,2015-12-31,julija in alfa romeo,560000,0,8462,-551538,False
5423,24,1931-12-26,mata hari,558000,900000,900000,342000,True
5424,25,1980-05-09,friday the 13th,550000,39754601,59754601,59204601,True
5425,26,1984-04-27,love letters,550000,5269990,5269990,4719990,True
5426,27,2014-09-12,faith connections,550000,9111,9111,-540889,False
5427,28,2012-03-06,high road,546173,0,0,-546173,False
5428,29,2008-09-26,fireproof,500000,33456317,33473297,32973297,True
5429,30,1974-11-15,benji,500000,31559560,31559560,31059560,True
5430,31,2004-08-06,open water,500000,30500882,55518641,55018641,True
5431,32,1977-01-01,kingdom of the spiders,500000,17000000,17000000,16500000,True
5432,33,2005-05-13,mad hot ballroom,500000,8117961,9387581,8887581,True
5433,34,2003-10-03,the station agent,500000,5801558,9470209,8970209,True
5434,35,2010-01-22,to save a life,500000,3777210,3824868,3324868,True
5435,36,2006-06-16,wordplay,500000,3121270,3177636,2677636,True
5436,37,1999-10-22,beyond the mat,500000,2047570,2047570,1547570,True
5437,38,2002-02-01,the singles ward,500000,1250798,1250798,750798,True
5438,39,2011-07-08,sholem aleichem: laughing in the darkness,500000,1131261,1131261,631261,True
5439,40,2004-01-30,osama,500000,1127331,1971479,1471479,True
5440,41,2000-06-09,groove,500000,1115313,1167524,667524,True
5441,42,2003-01-31,the r.m.,500000,1111615,1111615,611615,True
5442,43,1999-07-30,twin falls idaho,500000,985341,1027228,527228,True
5443,44,2004-08-20,mean creek,500000,603951,1348750,848750,True
5444,45,2013-08-23,drinking buddies,500000,343706,407100,-92900,False
5445,46,1998-02-13,hurricane streets,500000,334041,367582,-132418,False
5446,47,2002-07-12,never again,500000,307631,308793,-191207,False
5447,48,1956-11-19,shichinin no samurai,500000,271736,271736,-228264,False
5448,49,2003-08-29,civil brand,500000,254293,254293,-245707,False
5449,50,2010-10-29,monsters,500000,237301,5639730,5139730,False
5450,51,2006-03-24,lonesome jim,500000,154187,602789,102789,False
5451,52,2013-04-17,deceptive practice: the mysteries and mentors of ricky jay,500000,152449,152449,-347551,False
5452,53,2012-09-28,the other dream team,500000,134109,314444,-185556,False
5453,54,2015-12-11,o menino e o mundo,500000,129479,280967,-219033,False
5454,55,2011-04-01,rubber,500000,100370,680914,180914,False
5455,56,1991-01-01,johnny suede,500000,55000,55000,-445000,False
5456,57,2007-10-05,finishing the game,500000,52850,53201,-446799,False
5457,58,2008-04-18,kiss the bride,500000,32033,32033,-467967,False
5458,59,2003-07-11,the journey,500000,19800,19800,-480200,False
5459,60,2009-04-23,home,500000,15433,44793168,44293168,False
5460,61,2003-01-10,the slaughter rule,500000,13134,13134,-486866,False
5461,62,2010-05-14,the living wake,500000,12232,12232,-487768,False
5462,63,2009-02-27,scott walker: 30 century man,500000,6840,77121,-422879,False
5463,64,2005-10-21,the californians,500000,4134,4134,-495866,False
5464,65,2014-09-10,born to fly: elizabeth streb vs. gravity,500000,1822,1822,-498178,False
5465,66,2013-06-28,detention of the dead,500000,1778,1778,-498222,False
5466,67,2018-05-11,higher power,500000,528,528,-499472,False
5467,68,2006-12-31,feng kuang de shi tou,500000,0,3000000,2500000,False
5468,69,2013-01-08,now is good,500000,0,2141436,1641436,False
5469,70,2006-12-31,griffin & phoenix,500000,0,1355967,855967,False
5470,71,2001-11-02,everything put together,500000,0,7890,-492110,False
5471,72,2010-12-31,drones,500000,0,0,-500000,False
5472,73,2012-04-03,enter nowhere,500000,0,0,-500000,False
5473,74,2012-07-17,girls gone dead,500000,0,0,-500000,False
5474,75,2005-12-31,insomnia manica,500000,0,0,-500000,False
5475,76,2014-12-31,america is still the place,500000,0,0,-500000,False
5476,77,2015-07-24,the outrageous sophie tucker,500000,0,0,-500000,False
5477,78,2015-03-10,subconscious,500000,0,0,-500000,False
5478,79,2015-04-14,roadside,500000,0,0,-500000,False
5479,80,2014-12-31,diamond ruff,500000,0,0,-500000,False
5480,81,2015-02-10,love in the time of monsters,500000,0,0,-500000,False
5481,82,2012-12-31,el rey de najayo,500000,0,0,-500000,False
5482,83,2015-12-31,fight to the finish,500000,0,0,-500000,False
5483,84,2013-12-31,bucky and the squirrels,500000,0,0,-500000,False
5484,85,1990-12-31,going under,500000,0,0,-500000,False
5485,86,2015-06-23,crossroads,500000,0,0,-500000,False
5486,87,2015-08-11,alleluia! the devil's carnival,500000,0,0,-500000,False
5487,88,2015-12-01,brooklyn bizarre,500000,0,0,-500000,False
5488,89,2014-12-31,the sound and the shadow,500000,0,0,-500000,False
5489,90,2015-12-31,rodeo girl,500000,0,0,-500000,False
5490,91,2015-11-10,the little ponderosa zoo,500000,0,0,-500000,False
5491,92,1984-12-31,the toxic avenger,475000,0,0,-475000,False
5492,93,2009-09-25,paranormal activity,450000,107918810,194183034,193733034,True
5493,94,1991-01-01,straight out of brooklyn,450000,2712293,2712293,2262293,True
5494,95,2006-03-31,brick,450000,2075743,4243996,3793996,True
5495,96,1997-08-22,sunday,450000,410919,450349,349,False
5496,97,2006-08-11,conversations with other women,450000,379418,1297745,847745,False
5497,98,2015-11-20,siakh lokhamim: ha'slilim ha'gnouzim,450000,41260,42503,-407497,False
5498,99,2008-05-09,poultrygeist: night of the chicken dead,450000,13804,22623,-427377,False
5499,100,2014-07-11,as it is in heaven,450000,13486,13486,-436514,False
5500,1,2014-07-01,mutual friends,450000,0,0,-450000,False
5501,2,2014-12-31,rise of the entrepreneur - the search for a better way,450000,0,0,-450000,False
5502,3,1933-03-09,42nd street,439000,1438000,2281000,1842000,True
5503,4,1990-08-03,metropolitan,430000,2938000,2938000,2508000,True
5504,5,2006-04-28,moartea domnului lazarescu,425000,80301,581304,156304,False
5505,6,2005-01-21,gory gory hallelujah,425000,12604,12604,-412396,False
5506,7,2014-04-25,blue ruin,420000,258384,437002,17002,False
5507,8,2004-06-11,napoleon dynamite,400000,44540956,46122713,45722713,True
5508,9,1975-05-10,monty python and the holy grail,400000,3427696,5028948,4628948,True
5509,10,2006-08-02,quinceanera,400000,1692693,2797199,2397199,True
5510,11,2002-04-26,dogtown and z-boys,400000,1293295,1600566,1200566,True
5511,12,2008-10-24,heroes,400000,655538,655538,255538,True
5512,13,2004-10-06,tarnation,400000,592014,1162014,762014,True
5513,14,2010-10-15,i want your money,400000,433588,433588,33588,True
5514,15,1983-01-01,e tu vivrai nel terrore - l'aldilã,400000,126387,126387,-273613,False
5515,16,1980-05-16,home movies,400000,89134,89134,-310866,False
5516,17,2001-07-27,jackpot,400000,44452,44452,-355548,False
5517,18,2004-12-10,fabled,400000,31425,31425,-368575,False
5518,19,2005-10-13,the dark hours,400000,423,423,-399577,False
5519,20,2015-03-31,viskningar och rop,400000,0,9071,-390929,False
5520,21,1986-04-01,my beautiful laundrette,400000,0,0,-400000,False
5521,22,2005-11-04,show me,400000,0,0,-400000,False
5522,23,2014-12-31,pancakes,400000,0,0,-400000,False
5523,24,1916-09-05,intolerance,385907,0,0,-385907,False
5524,25,1929-02-01,the broadway melody,379000,2800000,4358000,3979000,True
5525,26,1983-04-15,the evil dead,375000,2400000,29400000,29025000,True
5526,27,1999-05-21,trekkies,375000,617172,617172,242172,True
5527,28,1980-01-01,maniac,350000,10000000,10000000,9650000,True
5528,29,1987-01-01,american ninja 2: the confrontation,350000,4000000,4000000,3650000,True
5529,30,2005-07-08,murderball,350000,1531154,1772979,1422979,True
5530,31,2010-09-01,my dog tulip,350000,246574,310891,-39109,False
5531,32,2006-10-18,51 birch street,350000,84689,84689,-265311,False
5532,33,2002-11-15,revolution#9,350000,9118,9118,-340882,False
5533,34,2009-04-10,royal kill,350000,0,0,-350000,False
5534,35,2015-10-20,rotor dr1,350000,0,0,-350000,False
5535,36,1957-04-13,12 angry men,340000,0,0,-340000,False
5536,37,1978-10-17,halloween,325000,47000000,70000000,69675000,True
5537,38,1934-02-22,it happened one night,325000,2500000,2500000,2175000,True
5538,39,2010-06-25,kynodontas,323000,110248,1373407,1050407,False
5539,40,1999-11-24,tumbleweeds,312000,1350248,1788168,1476168,True
5540,41,2003-11-14,tupac resurrection,300000,7718961,7808524,7508524,True
5541,42,2000-03-10,god's army,300000,2637726,2652515,2352515,True
5542,43,2003-10-17,pieces of april,300000,2528664,3571253,3271253,True
5543,44,1996-09-20,when the cat's away,300000,1652472,2525984,2225984,True
5544,45,2008-12-10,wendy and lucy,300000,865695,1416046,1116046,True
5545,46,1998-09-11,let's talk about sex,300000,373615,373615,73615,True
5546,47,2006-08-25,old joy,300000,255923,399908,99908,False
5547,48,2005-07-15,first morning,300000,87264,87264,-212736,False
5548,49,2007-06-15,pierrot le fou,300000,70807,71380,-228620,False
5549,50,1997-03-05,the watermelon woman,300000,42735,42735,-257265,False
5550,51,2011-03-11,3 backyards,300000,39475,39475,-260525,False
5551,52,2006-04-12,sisters in law,300000,33312,33312,-266688,False
5552,53,2012-11-09,nothing but a man,300000,17241,17241,-282759,False
5553,54,2002-07-19,ayurveda: art of being,300000,16892,2066892,1766892,False
5554,55,1998-08-07,"first love, last rites",300000,10876,10876,-289124,False
5555,56,2005-05-06,fighting tommy riley,300000,10514,10514,-289486,False
5556,57,2014-03-28,locker 13,300000,3496,3496,-296504,False
5557,58,2015-10-23,the looking glass,300000,1711,1711,-298289,False
5558,59,2014-10-31,all you need is love,300000,0,3565259,3265259,False
5559,60,1975-04-01,death race 2000,300000,0,0,-300000,False
5560,61,2012-07-03,some guy who kills people,300000,0,0,-300000,False
5561,62,2013-08-07,midnight cabaret,300000,0,0,-300000,False
5562,63,2015-03-10,teeth and blood,300000,0,0,-300000,False
5563,64,2015-12-31,walking to paris,300000,0,0,-300000,False
5564,65,2010-12-31,anderson's cross,300000,0,0,-300000,False
5565,66,2015-12-08,amidst the devil's wings,300000,0,0,-300000,False
5566,67,2010-12-31,death calls,290000,0,0,-290000,False
5567,68,2012-08-17,compliance,270000,319285,830700,560700,True
5568,69,1981-05-01,graduation day,250000,23894000,23894000,23644000,True
5569,70,1997-04-04,chasing amy,250000,12006514,15155095,14905095,True
5570,71,2002-06-28,lovely and amazing,250000,4210379,4613482,4363482,True
5571,72,2017-04-28,sleight,250000,3930990,3934450,3684450,True
5572,73,2003-04-11,better luck tomorrow,250000,3802390,3809226,3559226,True
5573,74,2011-10-28,like crazy,250000,3395391,3728400,3478400,True
5574,75,1995-06-16,the incredibly true adventure of two girls in love,250000,2210408,2477155,2227155,True
5575,76,2000-07-14,chuck&buck,250000,1055671,1157672,907672,True
5576,77,2001-03-16,american desi,250000,902835,1366235,1116235,True
5577,78,1998-09-11,cube,250000,489220,8969065,8719065,True
5578,79,1997-03-28,love and other catastrophes,250000,212285,743216,493216,False
5579,80,1998-08-28,i married a strange person,250000,203134,203134,-46866,False
5580,81,2005-07-22,november,250000,191862,191862,-58138,False
5581,82,1999-09-17,sugar town,250000,178095,178095,-71905,False
5582,83,2008-03-28,happy valley,250000,67665,67665,-182335,False
5583,84,2013-08-02,the canyons,250000,59671,62375,-187625,False
5584,85,2006-06-28,the motel,250000,51540,51540,-198460,False
5585,86,2005-07-15,on the outs,250000,49772,237816,-12184,False
5586,87,2007-12-14,shotgun stories,250000,46026,284174,34174,False
5587,88,2014-08-15,nightlights,250000,21147,21147,-228853,False
5588,89,2014-06-06,test,250000,18823,18823,-231177,False
5589,90,1999-01-08,the sticky fingers of time,250000,18195,20628,-229372,False
5590,91,2015-03-24,along the roadside,250000,0,3234,-246766,False
5591,92,2008-10-21,sunday school musical,250000,0,0,-250000,False
5592,93,2010-10-05,rust,250000,0,0,-250000,False
5593,94,2010-12-31,the christmas bunny,250000,0,0,-250000,False
5594,95,2009-11-10,ink,250000,0,0,-250000,False
5595,96,2012-12-18,the frozen,250000,0,0,-250000,False
5596,97,2014-04-11,jesus people,250000,0,0,-250000,False
5597,98,2010-12-31,butterfly,250000,0,0,-250000,False
5598,99,2015-02-03,undivided,250000,0,0,-250000,False
5599,100,2014-12-31,horse camp,250000,0,0,-250000,False
5600,1,2015-02-24,give me shelter,250000,0,0,-250000,False
5601,2,2011-12-31,rock the house,250000,0,0,-250000,False
5602,3,2015-12-31,shooting the warwicks,250000,0,0,-250000,False
5603,4,2015-08-18,the love letter,250000,0,0,-250000,False
5604,5,2015-10-09,western religion,250000,0,0,-250000,False
5605,6,2015-01-01,4/11,250000,0,0,-250000,False
5606,7,1925-11-19,the big parade,245000,11000000,22000000,21755000,True
5607,8,2008-10-31,little big top,240000,7484,7484,-232516,False
5608,9,2009-10-09,bronson,230000,104979,2703762,2473762,False
5609,10,2012-07-20,burn,225000,1109276,1109276,884276,True
5610,11,2000-09-15,urbania,225000,1032075,1032075,807075,True
5611,12,1953-06-13,"the beast from 20,000 fathoms",210000,5000000,5000000,4790000,True
5612,13,1969-07-25,the stewardesses,200000,13500000,25000000,24800000,True
5613,14,1980-03-21,mad max,200000,8750000,99750000,99550000,True
5614,15,1916-12-24,"20,000 leagues under the sea",200000,8000000,8000000,7800000,True
5615,16,1996-10-18,swingers,200000,4505922,6618578,6418578,True
5616,17,1967-01-18,per un pugno di dollari,200000,3500000,3516248,3316248,True
5617,18,2011-02-25,the grace card,200000,2430735,2430735,2230735,True
5618,19,1933-02-09,she done him wrong,200000,2000000,2000000,1800000,True
5619,20,2000-02-11,trois,200000,1161843,1161843,961843,True
5620,21,2015-06-19,the overnight,200000,1109808,1165996,965996,True
5621,22,2004-10-22,short cut to nirvana: kumbh mela,200000,381225,439651,239651,True
5622,23,2012-10-12,middle of nowhere,200000,236806,236806,36806,True
5623,24,2008-10-10,call+response,200000,212989,212989,12989,True
5624,25,2002-05-10,the business of fancy dancing,200000,174682,174682,-25318,False
5625,26,2002-05-10,hybrid,200000,162605,162605,-37395,False
5626,27,2008-06-13,baghead,200000,140016,140016,-59984,False
5627,28,2004-09-10,malevolence,200000,126021,346106,146106,False
5628,29,2005-09-09,side effects,200000,44701,44701,-155299,False
5629,30,2008-10-10,good dick,200000,28835,52443,-147557,False
5630,31,2006-07-21,the case of the grinning cat,200000,7033,7033,-192967,False
5631,32,2005-01-07,solitude,200000,6260,6260,-193740,False
5632,33,2014-03-14,the word,200000,3648,3648,-196352,False
5633,34,2007-06-15,the trials of darryl hunt,200000,1217,1217,-198783,False
5634,35,2007-10-19,the man from earth,200000,0,0,-200000,False
5635,36,2004-12-31,samantha: an american girl holiday,200000,0,0,-200000,False
5636,37,2008-01-17,yesterday was a lie,200000,0,0,-200000,False
5637,38,2014-09-12,archaeology of a woman,200000,0,0,-200000,False
5638,39,2014-08-26,sanctuary; quite a conundrum,200000,0,0,-200000,False
5639,40,2015-09-29,theresa is a mother,200000,0,0,-200000,False
5640,41,2015-11-10,perfect cowboy,200000,0,0,-200000,False
5641,42,2014-12-31,h.,200000,0,0,-200000,False
5642,43,2011-09-23,weekend,190000,484592,1577585,1387585,True
5643,44,1999-01-22,bacheha-ye aseman,180000,933933,1628579,1448579,True
5644,45,2015-02-27,butterfly girl,180000,17503,17503,-162497,False
5645,46,2017-06-16,arrowhead,180000,0,0,-180000,False
5646,47,1986-08-08,she's gotta have it,175000,7137502,7137502,6962502,True
5647,48,2011-07-22,another earth,175000,1321194,2102779,1927779,True
5648,49,2013-08-23,sparrows dance,175000,2602,2602,-172398,False
5649,50,2015-09-04,heroes of dirt,175000,0,0,-175000,False
5650,51,2016-06-03,the fits,170000,166425,169242,-758,False
5651,52,1979-06-30,dolphin,170000,14000,14000,-156000,False
5652,53,2015-12-31,lumea e a mea,168000,0,29678,-138322,False
5653,54,2009-09-11,the horse boy,160000,156612,156612,-3388,False
5654,55,2002-03-01,the calling,160000,32092,32092,-127908,False
5655,56,1971-01-01,sweet sweetback's baad asssss song,150000,15200000,15200000,15050000,True
5656,57,2007-05-16,once,150000,9445857,23323631,23173631,True
5657,58,2002-07-19,tadpole,150000,2891288,3270128,3120128,True
5658,59,2000-06-23,the woman chaser,150000,110719,110719,-39281,False
5659,60,2015-04-17,antarctic edge: 70âº south,150000,7193,7193,-142807,False
5660,61,2015-08-21,top spin,150000,5858,5858,-144142,False
5661,62,2013-12-31,speak no evil,150000,0,32927,-117073,False
5662,63,2009-10-06,a charlie brown christmas,150000,0,0,-150000,False
5663,64,2013-05-03,aroused,150000,0,0,-150000,False
5664,65,2015-12-31,escaping the holocost,150000,0,0,-150000,False
5665,66,1974-10-18,the texas chainsaw massacre,140000,26572439,26572439,26432439,True
5666,67,1989-12-20,roger & me,140000,6706368,6706368,6566368,True
5667,68,2012-04-27,sound of my voice,135000,408015,429448,294448,True
5668,69,1942-11-16,cat people,134000,4000000,8000000,7866000,True
5669,70,2014-07-18,an american in hollywood,125000,0,0,-125000,False
5670,71,2015-08-11,the brain that sings,125000,0,0,-125000,False
5671,72,2015-12-31,romantic schemer,125000,0,0,-125000,False
5672,73,2012-06-15,your sister's sister,120000,1597486,3090593,2970593,True
5673,74,2006-06-30,the blood of my brother: a story of death in iraq,120000,0,0,-120000,False
5674,75,2007-12-31,a dog's breakfast,120000,0,0,-120000,False
5675,76,2016-05-24,une femme mariã©e,120000,0,0,-120000,False
5676,77,1968-10-01,night of the living dead,114000,12087064,30087064,29973064,True
5677,78,1915-02-08,the birth of a nation,110000,10000000,11000000,10890000,True
5678,79,2003-10-03,the work and the story,103000,16137,16137,-86863,False
5679,80,2015-07-10,the gallows,100000,22764410,41656474,41556474,True
5680,81,2006-09-29,facing the giants,100000,10178331,10243159,10143159,True
5681,82,1977-01-01,eraserhead,100000,7000000,7014590,6914590,True
5682,83,1987-03-01,hollywood shuffle,100000,5228617,5228617,5128617,True
5683,84,1920-09-17,over the hill to the poorhouse,100000,3000000,3000000,2900000,True
5684,85,1998-10-09,the mighty,100000,2652246,6121582,6021582,True
5685,86,2017-07-07,a ghost story,100000,1594798,2769782,2669782,True
5686,87,1980-05-10,penitentiary,100000,287000,287000,187000,True
5687,88,2004-02-06,the lost skeleton of cadavra,100000,110536,110536,10536,True
5688,89,2014-03-21,cheap thrills,100000,59424,59424,-40576,False
5689,90,2014-06-19,the past is a grotesque animal,100000,20056,20056,-79944,False
5690,91,2001-11-09,keeping it real: the adventures of greg walloch,100000,1358,1358,-98642,False
5691,92,2012-05-18,indie game: the movie,100000,0,0,-100000,False
5692,93,2014-12-31,"dude, where's my dog",100000,0,0,-100000,False
5693,94,2014-06-10,echo dr.,100000,0,0,-100000,False
5694,95,2015-03-17,closure,100000,0,0,-100000,False
5695,96,2015-12-31,lunchtime heroes,100000,0,0,-100000,False
5696,97,2015-03-25,open secret,100000,0,0,-100000,False
5697,98,2015-11-10,the night visitor,100000,0,0,-100000,False
5698,99,2015-07-07,tiger orange,100000,0,0,-100000,False
5699,100,1972-08-30,the last house on the left,87000,3100000,3100000,3013000,True
5700,1,2008-05-30,the foot fist way,79000,234286,234286,155286,True
5701,2,2015-07-17,dawn of the crescent moon,75000,8799,8799,-66201,False
5702,3,2015-09-29,queen crab,75000,0,0,-75000,False
5703,4,2014-07-25,happy christmas,70000,30312,30312,-39688,False
5704,5,2005-01-28,"peace, propaganda and the promised land",70000,4930,4930,-65070,False
5705,6,2011-12-31,absentia,70000,0,8555,-61445,False
5706,7,1998-07-10,pi,68000,3221152,4678513,4610513,True
5707,8,1998-02-20,i love you â¦ don't touch me!,68000,33598,33598,-34402,False
5708,9,1999-02-26,20 dates,66000,541636,602920,536920,True
5709,10,2004-05-07,super size me,65000,11529368,22233808,22168808,True
5710,11,2013-01-25,supporting characters,60000,4917,4917,-55083,False
5711,12,2012-03-16,the fp,60000,0,0,-60000,False
5712,13,2012-12-31,hayride,60000,0,0,-60000,False
5713,14,1962-08-10,the brain that wouldn't die,60000,0,0,-60000,False
5714,15,2013-10-04,the dirties,55000,0,0,-55000,False
5715,16,1995-08-09,the brothers mcmullen,50000,10426506,10426506,10376506,True
5716,17,2001-03-16,gabriela,50000,2335352,2335352,2285352,True
5717,18,2010-11-12,tiny furniture,50000,391674,424149,374149,True
5718,19,2008-02-22,the signal,50000,251150,406299,356299,True
5719,20,2015-07-31,counting,50000,8374,8374,-41626,False
5720,21,2009-12-31,big things,50000,0,0,-50000,False
5721,22,2014-02-14,down and dangerous,50000,0,0,-50000,False
5722,23,2005-12-31,the call of cthulhu,50000,0,0,-50000,False
5723,24,2015-08-04,bending steel,50000,0,0,-50000,False
5724,25,2015-09-01,"run, hide, die",50000,0,0,-50000,False
5725,26,2014-12-31,the image revolution,50000,0,0,-50000,False
5726,27,2013-10-25,a true story,45000,0,0,-45000,False
5727,28,2000-10-27,george washington,42000,241816,342722,300722,True
5728,29,2013-06-21,this is martin bonner,42000,0,0,-42000,False
5729,30,2000-08-25,smiling fish and goat on fire,40000,277233,277233,237233,True
5730,31,2010-03-12,the exploding girl,40000,25572,25572,-14428,False
5731,32,2011-02-11,raymond did it,40000,3632,3632,-36368,False
5732,33,2012-03-31,foreign letters,40000,0,0,-40000,False
5733,34,1991-07-01,the last waltz,35000,321952,322563,287563,True
5734,35,2013-10-25,her cry: la llorona investigation,35000,0,0,-35000,False
5735,36,2014-12-31,happy 40th,35000,0,0,-35000,False
5736,37,2008-07-18,the legend of god's gun,30000,243768,243768,213768,True
5737,38,2016-03-18,krisha,30000,144822,144822,114822,True
5738,39,2006-09-01,mutual appreciation,30000,103509,103509,73509,True
5739,40,2005-04-29,funny ha ha,30000,77070,82698,52698,True
5740,41,2010-10-15,down terrace,30000,9812,9812,-20188,False
5741,42,2013-12-31,paraphobia,30000,0,0,-30000,False
5742,43,1994-10-19,clerks,27000,3073428,3894240,3867240,True
5743,44,1999-12-24,pink narcissus,27000,8231,8231,-18769,False
5744,45,2017-01-27,emily,27000,3547,3547,-23453,False
5745,46,1972-06-30,deep throat,25000,45000000,45000000,44975000,True
5746,47,1997-08-01,in the company of men,25000,2883661,2883661,2858661,True
5747,48,2000-01-14,the terrorist,25000,195043,195043,170043,True
5748,49,2015-09-01,exeter,25000,0,489792,464792,False
5749,50,2003-06-13,manito,25000,0,0,-25000,False
5750,51,2015-04-21,ten,25000,0,0,-25000,False
5751,52,2015-12-01,dutch kills,25000,0,0,-25000,False
5752,53,1991-08-01,slacker,23000,1227508,1227508,1204508,True
5753,54,2014-12-31,dry spell,22000,0,0,-22000,False
5754,55,2003-12-31,flywheel,20000,0,0,-20000,False
5755,56,2013-01-04,all superheroes must die,20000,0,0,-20000,False
5756,57,2015-04-21,the front man,20000,0,0,-20000,False
5757,58,2003-12-01,steel spirit,20000,0,0,-20000,False
5758,59,2011-11-25,the ridges,17300,0,0,-17300,False
5759,60,2006-06-02,the puffy chair,15000,194523,195254,180254,True
5760,61,2010-04-02,breaking upwards,15000,115592,115592,100592,True
5761,62,2014-12-31,stories of our lives,15000,0,0,-15000,False
5762,63,1997-04-11,pink flamingos,12000,413802,413802,401802,True
5763,64,2006-04-28,grip: a criminal's story,12000,1336,1336,-10664,False
5764,65,2007-12-31,tin can man,12000,0,0,-12000,False
5765,66,2001-03-09,dayereh,10000,673780,673780,663780,True
5766,67,2006-04-28,clean,10000,138711,138711,128711,True
5767,68,2001-07-06,cure,10000,94596,94596,84596,True
5768,69,2004-05-28,on the downlow,10000,1987,1987,-8013,False
5769,70,1996-04-01,bang,10000,527,527,-9473,False
5770,71,2008-08-14,the rise and fall of miss thang,10000,401,401,-9599,False
5771,72,2015-05-19,family motocross,10000,0,0,-10000,False
5772,73,2012-01-13,newlyweds,9000,4584,4584,-4416,False
5773,74,1993-02-26,el mariachi,7000,2040920,2041928,2034928,True
5774,75,2004-10-08,primer,7000,424760,841926,834926,True
5775,76,2006-05-26,cavite,7000,70071,71644,64644,True
5776,77,2004-12-31,the mongol king,7000,900,900,-6100,False
5777,78,2018-12-31,red 11,7000,0,0,-7000,False
5778,79,1999-04-02,following,6000,48482,240495,234495,True
5779,80,2005-07-13,return to the land of wonders,5000,1338,1338,-3662,False
5780,81,2015-09-29,a plague so pleasant,1400,0,0,-1400,False
5781,82,2005-08-05,my date with drew,1100,181041,181041,179941,True
